      3 跨國數據	同性婚姻合法化	社會將會變成什麼樣子
      2 顧客服務	雜誌訂閱	廣告刊登
      2 雜誌訂閱	廣告刊登	人才招募
      2 關於天下雜誌群	顧客服務	雜誌訂閱
      2 DEL	點	DEL
      2 886	2	2662
      1 點數不足	付費閱讀將扣除10點	請先購買點數
      1 點	DEL	點數不足
      1 點	DEL	付費閱讀將扣除10點
      1 黃明堂	瀏覽數	48353
      1 高度開發	國家	包括2006年接連通過同性伴侶擁有伴侶權及婚姻權的南非
      1 首頁	登入	註冊
      1 首頁	政治社會	社會現場
      1 首先	反同陣營對於同性婚姻合法化的第一個疑慮便是同性之間可以結婚將會降低生育率	使少子化現象惡化
      1 食在安心	新食力心服務	教育
      1 顏擇雅	還是新人	從實踐中確認新聞不是人云亦云
      1 頁尾	社群分享	facebook
      1 難有交集	同婚合法化並非先進國家的專利	在2016
      1 雜誌訂閱	國際書展	登入
      1 雜誌	特色頻道	未來城市
      1 雖然這種說法是一種滑坡謬誤	實際上	跨國數據分析結果顯示給予同性擁有共組家庭的權利不僅不會影響社會的性別教育
      1 雖然我們知道天災常以人禍的形式對人	們的生命	財產產生威脅
      1 隱私權政策與使用條款	讀者服務專線	886
      1 降低等危機	見表一	反對同婚者循著全球發展程度的觀點指出
      1 降低死亡率	並增加平均餘命	由此可見
      1 阿根廷	美國三國跳過伴侶權直接通過同性婚姻合法化	實際狀況是
      1 關閉對話區塊	請先登入會員	即可收藏文章
      1 關閉對話區塊	您目前的點數為	4250
      1 關閉對話區塊	您未曾有過購買知識庫點數	付費閱讀將扣除10點
      1 關鍵字	同志	同性婚姻
      1 關於更多cookies資訊請閱讀我們的隱私權政策與使用條款	我知道了	cwlogo
      1 開關分享區	跨國數據	同性婚姻合法化
      1 鄭雁馨老師	周亞萱小姐	楊芷蘭小姐提供相關資料及文章書寫的建議
      1 都稱不上是高度發展的國家	該國通過法案之年度的人均GDP	甚至都遠低於台灣目前的人均GDP
      1 都是	民主	國家
      1 那麼同性婚姻合法化將有助於提	升人們的性別意識	減少權力分布的性別差異
      1 還是新人	從實踐中確認新聞不是人云亦云	請睜開雙眼放下成見
      1 還不是會員嗎	立即註冊	立即贈天下旗艦版APP
      1 遍及5大洲	137國的資料庫	看看同性婚姻合法化後的國家
      1 進而造成愛滋病的擴散	然而	從表三第三區塊的分析結果來看
      1 進而推論少子女化的台灣社會在通過同性婚姻合法化之後	生育率將陷入更低點	為回應此疑慮
      1 進而導致人類滅絕	2014年馬政府執政時期	法務部報告內容指出
      1 週五	09	00
      1 週一	週五	09
      1 造訪我的網站	你可能有興趣的文章	中國輸出入銀行
      1 造成人們不均等的受災風險及差異的災後復原能力	因此	若社會的資源分
      1 通過同性婚姻的國家都是高度發展的國家	認為當國家發展至一定程度之後	人民才能夠
      1 通過同性婚姻法案與國家經濟發展程度並無對應關係	這些國家共同的特性為	都是
      1 通過同性婚姻法案的國家並非都是反對方口中的	高度開發	國家
      1 這篇文章都提供見解	2012	年12
      1 這是我的視野	你可以否定	但無法取代
      1 這些更有可能是降低異性戀家庭生育率的主因	上帝並不會懲罰同婚的國度	第二
      1 這些國家共同的特性為	都是	民主
      1 透過橫跨1980至2013年	遍及5大洲	137國的資料庫
      1 農地上的世界冠軍	兩千大企業調查	工業4
      1 轉寄	開關分享區	跨國數據
      1 跨國數據分析結果顯示給予同性擁有共組家庭的權利不僅不會影響社會的性別教育	反而可能有機會提升兩性	性別之間權力分布更平等
      1 購買點數	關閉對話區塊	您目前的點數為
      1 購買點數	取消	關閉對話區塊
      1 賦予同性組成家庭的權利有助於降低男性及女性HIV	的盛行率	因為
      1 貿易戰	財經焦點	財經週報
      1 財經週報	投資理財	循環經濟
      1 財經焦點	財經週報	投資理財
      1 財經時事	國際	經營管理
      1 財經	貿易戰	財經焦點
      1 財產產生威脅	但這主要透過社會中既有的不平等分布	政治經濟等因素
      1 讓愛啟動	創新驚艷全球	藍色觀點
      1 讓同性	有機會進入婚姻來維繫穩定的關係	反而有助於降低不安全性行為發生的可能性
      1 讓人們對於性	別	性
      1 讓不	能	自然
      1 讀者服務專線	886	2
      1 謝誌	本文感謝中研院社會所林宗弘老師	鄭雁馨老師
      1 論壇活動	更多服務	關於天下雜誌群
      1 請睜開雙眼放下成見	卻不要失去態度	這是我的視野
      1 請先購買點數	購買點數	取消
      1 請先購買點數	取消	購買點數
      1 請先登入會員	即可收藏文章	登入
      1 調查	經濟學人	公告
      1 調整字體尺寸	透過橫跨1980至2013年	遍及5大洲
      1 認為當國家發展至一定程度之後	人民才能夠	接受
      1 該國通過法案之年度的人均GDP	甚至都遠低於台灣目前的人均GDP	因此
      1 該國的總生育率及國民的生命表徵是否受到衝擊	我們從與生命延續相關的三個變數切入	總生育率
      1 註冊	首頁	登入
      1 註冊	您可以於我的帳戶中追蹤的作者管理	子導覽列
      1 註冊	今日最新	內容總覽
      1 設計	藝文	影視
      1 親子教養	海闊天空	2018教育特刊專輯
      1 見表一	反對同婚者循著全球發展程度的觀點指出	通過同性婚姻的國家都是高度發展的國家
      1 要求的婚姻制度中	讓同性	有機會進入婚姻來維繫穩定的關係
      1 表三第二區塊的分析結果顯示	自然災害的發生及自然災害帶來的死亡與該國是否通過同性婚姻合法與否無關	雖然我們知道天災常以人禍的形式對人
      1 表三第一區塊的分析結果顯示	反同團體憂慮的生育率下降之衝擊實際上並不存在	讓不
      1 衝擊我國人口存續	台灣守護家庭聯盟及婦女同心會都宣稱	同性婚姻不具自然生育的可能性
      1 行銷	創新創業	人才
      1 藝文	影視	生活
      1 藍色觀點	數位專輯	數位專輯
      1 若讓同性婚姻合法將導致天譴	甚至將某些天然災害歸因於同性婚姻合法化	2016
      1 若繼續閱覽本網站內容	即表示您同意我們使用	cookies
      1 若社會的資源分	布不因性別	性傾向而異
      1 與其擔憂同性婚姻合法化對生育率造成的威脅	我們更	應該關注不友善的職場環境及不平等的家庭性別分工等問題
      1 自然災害的發生及自然災害帶來的死亡與該國是否通過同性婚姻合法與否無關	雖然我們知道天災常以人禍的形式對人	們的生命
      1 自然	生育能力	進而推論少子女化的台灣社會在通過同性婚姻合法化之後
      1 自然	生育的同志伴侶擁有相同的婚姻權並不會降低生育率	危及人類的存續
      1 自此之後	台灣各地加上2016	年的兩場公聽會
      1 能	自然	生育的同志伴侶擁有相同的婚姻權並不會降低生育率
      1 聽天下	財經	貿易戰
      1 職場競爭力	永續經營	讓愛啟動
      1 而非	不同性別組成的性行為	因此
      1 而同性婚姻不具有公共利益	可能造成性別教育的敗壞	雖然這種說法是一種滑坡謬誤
      1 美國的某位基督教領袖也公開宣稱	上帝會降下天災以懲罰同性婚姻及墮胎合法化	但實際上
      1 美國三國跳過伴侶權直接通過同性婚姻合法化	實際狀況是	直接通過同婚合法化並沒有因此造成該國社會動盪及生育率
      1 繼續	關閉對話區塊	您未曾有過購買知識庫點數
      1 總計開了至少十場同性婚姻公聽會	但正	反方的意見仍舊分歧
      1 總生育率	死亡率及平均餘命	表三第一區塊的分析結果顯示
      1 經營管理	管理	行銷
      1 經營管理	時尚生活	環境
      1 經濟學人	公告	數據圖表
      1 精華簡文	跨國數據	同性婚姻合法化
      1 管理	行銷	創新創業
      1 第二	有些極端的宗教人士宣稱同性戀是罪	若讓同性婚姻合法將導致天譴
      1 第三	反同者最常用以反對同志	特別是男同志
      1 立即贈天下旗艦版APP	專屬體驗價	最佳的數位閱讀體驗
      1 立即註冊	立即贈天下旗艦版APP	專屬體驗價
      1 立即登入	全閱讀半年1111元	我知道了
      1 社群分享	facebook	google
      1 社會現場	跨國數據	同性婚姻合法化
      1 社會歷經了怎麼樣的變化	生育率會下降嗎	人類會滅絕嗎
      1 社會將會變成什麼樣子	精華簡文	跨國數據
      1 社會將會變成什麼樣子	大家出版	文
      1 社會將會變成什麼樣子	圖片來源	黃明堂
      1 看看同性婚姻合法化後的國家	社會歷經了怎麼樣的變化	生育率會下降嗎
      1 直接通過同婚合法化並沒有因此造成該國社會動盪及生育率	降低等危機	見表一
      1 的觀點就是同性戀帶來愛滋病的傳播	台灣守護家庭聯盟就直指男男之間的性行為是感染愛滋病的大宗	因此
      1 的盛行率	因為	性行為與愛滋病之間的連結在於
      1 登入	還不是會員嗎	立即註冊
      1 登入	註冊	首頁
      1 登入	註冊	您可以於我的帳戶中追蹤的作者管理
      1 登入	註冊	今日最新
      1 疾病不會因此大爆發	反而透過	法令的執行
      1 當同性擁有共組家庭的權利之後	該國的總生育率及國民的生命表徵是否受到衝擊	我們從與生命延續相關的三個變數切入
      1 由此可見	同性婚姻合法化免除了將生育限定在異性戀家庭的限制	反而讓生命延續有更多可能性
      1 用專法取代修改	民法	然而
      1 產業	財經時事	國際
      1 生育能力	進而推論少子女化的台灣社會在通過同性婚姻合法化之後	生育率將陷入更低點
      1 生育的同志伴侶擁有相同的婚姻權並不會降低生育率	危及人類的存續	反而可以從係數的方向可見同性婚姻法制化傾向提升總生育率
      1 生育率會下降嗎	人類會滅絕嗎	愛滋病會不會因此蔓延
      1 生育率將陷入更低點	為回應此疑慮	我們從那些給予同性共組家庭合法地位的國家經驗來看
      1 生育率不會下降	人類不會滅絕	首先
      1 生育率	好友人數	文章下載
      1 生活	圖片故事	在現場
      1 甚至都遠低於台灣目前的人均GDP	因此	通過同性婚姻法案與國家經濟發展程度並無對應關係
      1 甚至是不同個體的尊重	減少因為性	別差異而來的差別待遇
      1 甚至將某些天然災害歸因於同性婚姻合法化	2016	年一位義大利神父指稱義大利北方發生的地震是上帝對同性婚姻合法化的懲罰
      1 環境	教育	人物觀點
      1 現在訂省最多	新春閱讀季	年度最優惠
      1 現在的天下網站	更快速	更穩定了
      1 獨立評論	天下	天下部落格
      1 特色頻道	未來城市	天下
      1 特別是男同志	的觀點就是同性戀帶來愛滋病的傳播	台灣守護家庭聯盟就直指男男之間的性行為是感染愛滋病的大宗
      1 熱門文章	現在訂省最多	新春閱讀季
      1 然而	從表三第三區塊的分析結果來看	賦予同性組成家庭的權利有助於降低男性及女性HIV
      1 然而	反對者忽略了國外經驗從同性伴侶擁有伴侶權或民事締結權利走到同性婚姻合法化	代表的是開放同性伴侶擁有民事締結的權利
      1 無限閱讀	了解更多	公告
      1 為提供您更多優質的內容	本網站使用cookies分析技術	若繼續閱覽本網站內容
      1 為回應此疑慮	我們從那些給予同性共組家庭合法地位的國家經驗來看	當同性擁有共組家庭的權利之後
      1 瀏覽數	48353	分享
      1 溫暖的軌道	三環三線	想像未來
      1 減少權力分布的性別差異	因此	從各國的經驗來看
      1 減少因為性	別差異而來的差別待遇	讓人們對於性
      1 深度專題	農地上的世界冠軍	兩千大企業調查
      1 海闊天空	2018教育特刊專輯	雜誌
      1 活動訊息	活動訊息	上一頁
      1 活動訊息	上一頁	下一頁
      1 法案之後	對其國家社會發展的影響	包括自然災害發生率的變化
      1 法務部報告內容指出	同性婚姻恐衝擊現有婚姻制度	並擔心同性婚姻會造成少子化
      1 法令的執行	提倡尊重不同的性傾向及性少數	提升人民對於不同性別
      1 永續經營	讓愛啟動	創新驚艷全球
      1 民法	然而	反對者忽略了國外經驗從同性伴侶擁有伴侶權或民事締結權利走到同性婚姻合法化
      1 民主	國家	尊重
      1 死亡率變化	人民的平均餘命變化	兩性的HIV盛行率變化及代表性別態度的兩性權力分布平等化指標等
      1 死亡率及平均餘命	表三第一區塊的分析結果顯示	反同團體憂慮的生育率下降之衝擊實際上並不存在
      1 歡迎重新登入	使用我們提供的各種服務	立即登入
      1 楊芷蘭小姐提供相關資料及文章書寫的建議	本文摘自大家出版	性別作為動詞
      1 本網站使用cookies分析技術	若繼續閱覽本網站內容	即表示您同意我們使用
      1 本文摘自大家出版	性別作為動詞	巷仔口社會學2
      1 本文感謝中研院社會所林宗弘老師	鄭雁馨老師	周亞萱小姐
      1 本文從跨國資料庫檢視同性擁有合法共組家庭權利之國家的發展	以回應對同性婚姻合法將造成社會動盪之疑慮	本文分析的跨國長期資料庫橫跨五大洲
      1 本文分析的跨國長期資料庫橫跨五大洲	137國	時間區段則從1980至2013年
      1 未來城市	天下	CSR
      1 服務時間	週一	週五
      1 有機會進入婚姻來維繫穩定的關係	反而有助於降低不安全性行為發生的可能性	打造更友善的性別空間
      1 有反同婚學者指出以世界領頭羊國家通過同性婚姻合法化	作為同性婚姻合法化說詞並不合理	並認為同性婚姻法制化將帶來社會動盪
      1 有些極端的宗教人士宣稱同性戀是罪	若讓同性婚姻合法將導致天譴	甚至將某些天然災害歸因於同性婚姻合法化
      1 月立法院尤美女委員在司法及法制委員會召開了第一場同性婚姻公聽會	自此之後	台灣各地加上2016
      1 最後	反對同婚合法者認為相較於異性戀婚姻具有生育下一代的社會功能	而同性婚姻不具有公共利益
      1 最佳的數位閱讀體驗	12週優惠	一天5元
      1 更穩定了	歡迎重新登入	使用我們提供的各種服務
      1 更快速	更穩定了	歡迎重新登入
      1 更多服務	關於天下雜誌群	顧客服務
      1 更多元	所以	同性婚姻合法化更有可能成為帶動性別平等的新契機
      1 時間區段則從1980至2013年	以固定效果模型	探討各國在通過同性共組家庭
      1 時尚頻道	幸福	家居
      1 時尚精品	旅行	設計
      1 時尚生活	環境	教育
      1 時尚生活	時尚精品	旅行
      1 是否繼續	取消	繼續
      1 旗艦上市	QRcode	apple_itunes_app
      1 旅行	設計	藝文
      1 新食力心服務	教育	教育趨勢
      1 新春閱讀季	年度最優惠	您目前的點數為
      1 新南向	時尚生活	時尚精品
      1 文章下載	PDF下載	付費閱讀
      1 文	張宜君	2017
      1 數據圖表	政治社會	專欄
      1 數位專輯	深度專題	農地上的世界冠軍
      1 數位專輯	數位專輯	深度專題
      1 教育趨勢	創新教育	親子教養
      1 教育	教育趨勢	創新教育
      1 教育	人物觀點	調查
      1 政治經濟等因素	造成人們不均等的受災風險及差異的災後復原能力	因此
      1 政治社會	社會現場	跨國數據
      1 政治社會	熱門文章	現在訂省最多
      1 政治社會	專欄	健康關係
      1 政府應該領頭	帶著人民走向性別更平等的台灣社會	謝誌
      1 搜尋	天下全閱讀	切換搜尋選單
      1 搜尋	____________________	Submit
      1 換日線	天下影音	微笑台灣319鄉
      1 提升人民對於不同性別	甚至是不同個體的尊重	減少因為性
      1 提出採	用專法取代修改	民法
      1 提倡尊重不同的性傾向及性少數	提升人民對於不同性別	甚至是不同個體的尊重
      1 接著	本文從跨國資料庫檢視同性擁有合法共組家庭權利之國家的發展	以回應對同性婚姻合法將造成社會動盪之疑慮
      1 接受	同性婚姻合法化	但表二顯示
      1 探討各國在通過同性共組家庭	包括民事締結或婚姻合法化	法案之後
      1 投資理財	循環經濟	溫暖的軌道
      1 打造更友善的性別空間	最後	反對同婚合法者認為相較於異性戀婚姻具有生育下一代的社會功能
      1 所以	同性婚姻合法化更有可能成為帶動性別平等的新契機	政府應該領頭
      1 我讀網	創新學院	換日線
      1 我知道了	IFRAME	popup_dfp
      1 我知道了	cwlogo	切換側邊選單
      1 我們更	應該關注不友善的職場環境及不平等的家庭性別分工等問題	這些更有可能是降低異性戀家庭生育率的主因
      1 我們從那些給予同性共組家庭合法地位的國家經驗來看	當同性擁有共組家庭的權利之後	該國的總生育率及國民的生命表徵是否受到衝擊
      1 我們從與生命延續相關的三個變數切入	總生育率	死亡率及平均餘命
      1 我們升級了	上週我們進行了全站系統升級	現在的天下網站
      1 應該關注不友善的職場環境及不平等的家庭性別分工等問題	這些更有可能是降低異性戀家庭生育率的主因	上帝並不會懲罰同婚的國度
      1 愛滋病會不會因此蔓延	這篇文章都提供見解	2012
      1 愛滋不會因此蔓延	第三	反同者最常用以反對同志
      1 想像未來	儲備正能量	經營管理
      1 您目前的點數為	5	DEL
      1 您目前的點數為	4250	DEL
      1 您未曾有過購買知識庫點數	付費閱讀將扣除10點	請先購買點數
      1 您可以於我的帳戶中追蹤的作者管理	子導覽列	English
      1 性行為與愛滋病之間的連結在於	不安全的性行為	而非
      1 性忠貞	要求的婚姻制度中	讓同性
      1 性別教育的目的在於追求性別平等與相互尊重	也就是人們不會因為性別而受到不平等的對待或不同的生命機會	那麼同性婚姻合法化將有助於提
      1 性別作為動詞	巷仔口社會學2	關鍵字
      1 性別之間權力分布更平等	如果我們認為	性別教育的目的在於追求性別平等與相互尊重
      1 性傾向而異	在此脈絡下反而有機會減少災難的不平等分布	愛滋不會因此蔓延
      1 性	別角色以及家庭的想像更友善	更多元
      1 心靈成長	小兒過敏	食在安心
      1 微笑台灣319鄉	論壇活動	更多服務
      1 循環經濟	溫暖的軌道	三環三線
      1 從跨國數據了解同婚之後會怎樣	接著	本文從跨國資料庫檢視同性擁有合法共組家庭權利之國家的發展
      1 從表三第三區塊的分析結果來看	賦予同性組成家庭的權利有助於降低男性及女性HIV	的盛行率
      1 從實踐中確認新聞不是人云亦云	請睜開雙眼放下成見	卻不要失去態度
      1 從各國的經驗來看	同性婚姻合法化不會為社會帶來不良的影響	不會減少生育率
      1 從各國的經驗來看	僅有南非	阿根廷
      1 影視	生活	圖片故事
      1 張宜君	2017	05
      1 廣告刊登	人才招募	隱私權政策與使用條款
      1 廣告刊登	人才招募	English
      1 幻燈片下一頁	首頁	政治社會
      1 幻燈片上一頁	幻燈片下一頁	首頁
      1 幸福	家居	健康關係
      1 年的兩場公聽會	總計開了至少十場同性婚姻公聽會	但正
      1 年末的公聽會上	有反同婚學者指出以世界領頭羊國家通過同性婚姻合法化	作為同性婚姻合法化說詞並不合理
      1 年度最優惠	您目前的點數為	5
      1 年一位義大利神父指稱義大利北方發生的地震是上帝對同性婚姻合法化的懲罰	美國的某位基督教領袖也公開宣稱	上帝會降下天災以懲罰同性婚姻及墮胎合法化
      1 年12	月立法院尤美女委員在司法及法制委員會召開了第一場同性婚姻公聽會	自此之後
      1 帶著人民走向性別更平等的台灣社會	謝誌	本文感謝中研院社會所林宗弘老師
      1 布不因性別	性傾向而異	在此脈絡下反而有機會減少災難的不平等分布
      1 巷仔口社會學2	關鍵字	同志
      1 工業4	0	新南向
      1 小兒過敏	食在安心	新食力心服務
      1 對其國家社會發展的影響	包括自然災害發生率的變化	出生率變化
      1 尊重	保障人民有不同婚姻選擇的機會	將其視為一
      1 專欄	健康關係	天下雜誌部落格
      1 專屬體驗價	最佳的數位閱讀體驗	12週優惠
      1 將其視為一	個民主政體的共同目標	從跨國數據了解同婚之後會怎樣
      1 實際狀況是	直接通過同婚合法化並沒有因此造成該國社會動盪及生育率	降低等危機
      1 實際上	跨國數據分析結果顯示給予同性擁有共組家庭的權利不僅不會影響社會的性別教育	反而可能有機會提升兩性
      1 家居	健康關係	健康醫療
      1 子導覽列	English	天下全閱讀
      1 如果我們認為	性別教育的目的在於追求性別平等與相互尊重	也就是人們不會因為性別而受到不平等的對待或不同的生命機會
      1 好友人數	文章下載	PDF下載
      1 天下雜誌部落格	聽天下	財經
      1 天下雜誌APP	旗艦上市	QRcode
      1 天下部落格	我讀網	創新學院
      1 天下影音	微笑台灣319鄉	論壇活動
      1 天下全閱讀	切換搜尋選單	切換會員選單
      1 天下全閱讀	免費下載App	天下雜誌APP
      1 天下	獨立評論	天下
      1 天下	天下部落格	我讀網
      1 天下	CSR	天下
      1 大家出版	文	張宜君
      1 在目前具有	性忠貞	要求的婚姻制度中
      1 在現場	時尚頻道	幸福
      1 在此脈絡下反而有機會減少災難的不平等分布	愛滋不會因此蔓延	第三
      1 在2016	年末的公聽會上	有反同婚學者指出以世界領頭羊國家通過同性婚姻合法化
      1 圖片故事	在現場	時尚頻道
      1 圖片來源	黃明堂	瀏覽數
      1 國際書展	登入	註冊
      1 國際	經營管理	時尚生活
      1 國家	尊重	保障人民有不同婚姻選擇的機會
      1 國家	包括2006年接連通過同性伴侶擁有伴侶權及婚姻權的南非	2010年通過
      1 因而最終仍需要同性婚姻權才能解決問題	從各國的經驗來看	僅有南非
      1 因為	性行為與愛滋病之間的連結在於	不安全的性行為
      1 因此	通過同性婚姻法案與國家經濟發展程度並無對應關係	這些國家共同的特性為
      1 因此	若社會的資源分	布不因性別
      1 因此	與其擔憂同性婚姻合法化對生育率造成的威脅	我們更
      1 因此	從各國的經驗來看	同性婚姻合法化不會為社會帶來不良的影響
      1 因此	在目前具有	性忠貞
      1 因此	同性婚姻合法化將會鼓勵同性之間的性行為	進而造成愛滋病的擴散
      1 周亞萱小姐	楊芷蘭小姐提供相關資料及文章書寫的建議	本文摘自大家出版
      1 同性戀	生育率	好友人數
      1 同性婚姻權的阿根廷	2013年通過法案的巴西和巴拉圭	2016年通過的哥倫比亞等國家
      1 同性婚姻恐衝擊現有婚姻制度	並擔心同性婚姻會造成少子化	衝擊我國人口存續
      1 同性婚姻合法化更有可能成為帶動性別平等的新契機	政府應該領頭	帶著人民走向性別更平等的台灣社會
      1 同性婚姻合法化將會鼓勵同性之間的性行為	進而造成愛滋病的擴散	然而
      1 同性婚姻合法化免除了將生育限定在異性戀家庭的限制	反而讓生命延續有更多可能性	因此
      1 同性婚姻合法化不會為社會帶來不良的影響	不會減少生育率	不會造成人類滅絕
      1 同性婚姻合法化	社會將會變成什麼樣子	精華簡文
      1 同性婚姻合法化	社會將會變成什麼樣子	大家出版
      1 同性婚姻合法化	社會將會變成什麼樣子	圖片來源
      1 同性婚姻合法化	但表二顯示	通過同性婚姻法案的國家並非都是反對方口中的
      1 同性婚姻不具自然生育的可能性	不利於台灣的家庭延續與人口發展	以上反同立場從同性之間缺乏
      1 同性婚姻	同性戀	生育率
      1 同志	同性婚姻	同性戀
      1 同婚合法化並非先進國家的專利	在2016	年末的公聽會上
      1 台灣守護家庭聯盟就直指男男之間的性行為是感染愛滋病的大宗	因此	同性婚姻合法化將會鼓勵同性之間的性行為
      1 台灣守護家庭聯盟及婦女同心會都宣稱	同性婚姻不具自然生育的可能性	不利於台灣的家庭延續與人口發展
      1 台灣各地加上2016	年的兩場公聽會	總計開了至少十場同性婚姻公聽會
      1 台北市104南京東路二段139號11樓	copyright	2019天下雜誌
      1 可能造成性別教育的敗壞	雖然這種說法是一種滑坡謬誤	實際上
      1 取消	關閉對話區塊	請先登入會員
      1 取消	購買點數	關閉對話區塊
      1 取消	繼續	關閉對話區塊
      1 反而透過	法令的執行	提倡尊重不同的性傾向及性少數
      1 反而讓生命延續有更多可能性	因此	與其擔憂同性婚姻合法化對生育率造成的威脅
      1 反而有助於降低不安全性行為發生的可能性	打造更友善的性別空間	最後
      1 反而可能有機會提升兩性	性別之間權力分布更平等	如果我們認為
      1 反而可以從係數的方向可見同性婚姻法制化傾向提升總生育率	降低死亡率	並增加平均餘命
      1 反方的意見仍舊分歧	難有交集	同婚合法化並非先進國家的專利
      1 反對者忽略了國外經驗從同性伴侶擁有伴侶權或民事締結權利走到同性婚姻合法化	代表的是開放同性伴侶擁有民事締結的權利	仍無法解決同性伴侶在法律上的不平等
      1 反對同婚者循著全球發展程度的觀點指出	通過同性婚姻的國家都是高度發展的國家	認為當國家發展至一定程度之後
      1 反對同婚合法者認為相較於異性戀婚姻具有生育下一代的社會功能	而同性婚姻不具有公共利益	可能造成性別教育的敗壞
      1 反同陣營對於同性婚姻合法化的第一個疑慮便是同性之間可以結婚將會降低生育率	使少子化現象惡化	進而導致人類滅絕
      1 反同者最常用以反對同志	特別是男同志	的觀點就是同性戀帶來愛滋病的傳播
      1 反同團體憂慮的生育率下降之衝擊實際上並不存在	讓不	能
      1 卻對同志最友善	作者	顏擇雅
      1 卻不要失去態度	這是我的視野	你可以否定
      1 即表示您同意我們使用	cookies	關於更多cookies資訊請閱讀我們的隱私權政策與使用條款
      1 即可收藏文章	登入	還不是會員嗎
      1 危及人類的存續	反而可以從係數的方向可見同性婚姻法制化傾向提升總生育率	降低死亡率
      1 升人們的性別意識	減少權力分布的性別差異	因此
      1 包括自然災害發生率的變化	出生率變化	死亡率變化
      1 包括民事締結或婚姻合法化	法案之後	對其國家社會發展的影響
      1 包括2006年接連通過同性伴侶擁有伴侶權及婚姻權的南非	2010年通過	同性婚姻權的阿根廷
      1 勇創新時代	側邊欄	活動訊息
      1 創新驚艷全球	藍色觀點	數位專輯
      1 創新教育	親子教養	海闊天空
      1 創新學院	換日線	天下影音
      1 創新創業	人才	職場競爭力
      1 別角色以及家庭的想像更友善	更多元	所以
      1 別差異而來的差別待遇	讓人們對於性	別
      1 別	性	別角色以及家庭的想像更友善
      1 切換會員選單	登入	註冊
      1 切換搜尋選單	切換會員選單	登入
      1 切換側邊選單	搜尋	____________________
      1 分享	LINE	google
      1 出生率變化	死亡率變化	人民的平均餘命變化
      1 公告	數據圖表	政治社會
      1 公告	我們升級了	上週我們進行了全站系統升級
      1 兩性關係	心靈成長	小兒過敏
      1 兩性的HIV盛行率變化及代表性別態度的兩性權力分布平等化指標等	生育率不會下降	人類不會滅絕
      1 兩千大企業調查	工業4	0
      1 全閱讀半年1111元	我知道了	IFRAME
      1 全台首富里不在天龍國	卻對同志最友善	作者
      1 內容總覽	產業	財經時事
      1 免費下載App	天下雜誌APP	旗艦上市
      1 儲備正能量	經營管理	管理
      1 僅有南非	阿根廷	美國三國跳過伴侶權直接通過同性婚姻合法化
      1 傳真電話	886	2
      1 側邊欄	活動訊息	活動訊息
      1 健康關係	天下雜誌部落格	聽天下
      1 健康關係	健康醫療	兩性關係
      1 健康醫療	兩性關係	心靈成長
      1 們的生命	財產產生威脅	但這主要透過社會中既有的不平等分布
      1 個民主政體的共同目標	從跨國數據了解同婚之後會怎樣	接著
      1 保障人民有不同婚姻選擇的機會	將其視為一	個民主政體的共同目標
      1 使用我們提供的各種服務	立即登入	全閱讀半年1111元
      1 使少子化現象惡化	進而導致人類滅絕	2014年馬政府執政時期
      1 你可能有興趣的文章	中國輸出入銀行	勇創新時代
      1 你可以否定	但無法取代	造訪我的網站
      1 作者	顏擇雅	還是新人
      1 作為同性婚姻合法化說詞並不合理	並認為同性婚姻法制化將帶來社會動盪	提出採
      1 但這主要透過社會中既有的不平等分布	政治經濟等因素	造成人們不均等的受災風險及差異的災後復原能力
      1 但表二顯示	通過同性婚姻法案的國家並非都是反對方口中的	高度開發
      1 但無法取代	造訪我的網站	你可能有興趣的文章
      1 但正	反方的意見仍舊分歧	難有交集
      1 但實際上	表三第二區塊的分析結果顯示	自然災害的發生及自然災害帶來的死亡與該國是否通過同性婚姻合法與否無關
      1 以固定效果模型	探討各國在通過同性共組家庭	包括民事締結或婚姻合法化
      1 以回應對同性婚姻合法將造成社會動盪之疑慮	本文分析的跨國長期資料庫橫跨五大洲	137國
      1 以上反同立場從同性之間缺乏	自然	生育能力
      1 代表的是開放同性伴侶擁有民事締結的權利	仍無法解決同性伴侶在法律上的不平等	因而最終仍需要同性婚姻權才能解決問題
      1 付費閱讀將扣除10點	請先購買點數	購買點數
      1 付費閱讀將扣除10點	請先購買點數	取消
      1 付費閱讀將扣除10點	是否繼續	取消
      1 付費閱讀	下一篇	全台首富里不在天龍國
      1 仍無法解決同性伴侶在法律上的不平等	因而最終仍需要同性婚姻權才能解決問題	從各國的經驗來看
      1 今日最新	內容總覽	產業
      1 人類會滅絕嗎	愛滋病會不會因此蔓延	這篇文章都提供見解
      1 人類不會滅絕	首先	反同陣營對於同性婚姻合法化的第一個疑慮便是同性之間可以結婚將會降低生育率
      1 人物觀點	調查	經濟學人
      1 人民的平均餘命變化	兩性的HIV盛行率變化及代表性別態度的兩性權力分布平等化指標等	生育率不會下降
      1 人民才能夠	接受	同性婚姻合法化
      1 人才招募	隱私權政策與使用條款	讀者服務專線
      1 人才招募	English	icon
      1 人才	職場競爭力	永續經營
      1 了解更多	公告	我們升級了
      1 也就是人們不會因為性別而受到不平等的對待或不同的生命機會	那麼同性婚姻合法化將有助於提	升人們的性別意識
      1 中國輸出入銀行	勇創新時代	側邊欄
      1 並認為同性婚姻法制化將帶來社會動盪	提出採	用專法取代修改
      1 並擔心同性婚姻會造成少子化	衝擊我國人口存續	台灣守護家庭聯盟及婦女同心會都宣稱
      1 並增加平均餘命	由此可見	同性婚姻合法化免除了將生育限定在異性戀家庭的限制
      1 不會造成人類滅絕	上帝不會降天譴	疾病不會因此大爆發
      1 不會減少生育率	不會造成人類滅絕	上帝不會降天譴
      1 不安全的性行為	而非	不同性別組成的性行為
      1 不同性別組成的性行為	因此	在目前具有
      1 不利於台灣的家庭延續與人口發展	以上反同立場從同性之間缺乏	自然
      1 下載天下雜誌APP	App	Store
      1 下一頁	政治社會	熱門文章
      1 下一篇	全台首富里不在天龍國	卻對同志最友善
      1 上週我們進行了全站系統升級	現在的天下網站	更快速
      1 上帝會降下天災以懲罰同性婚姻及墮胎合法化	但實際上	表三第二區塊的分析結果顯示
      1 上帝並不會懲罰同婚的國度	第二	有些極端的宗教人士宣稱同性戀是罪
      1 上帝不會降天譴	疾病不會因此大爆發	反而透過
      1 上一頁	下一頁	政治社會
      1 三環三線	想像未來	儲備正能量
      1 一天5元	無限閱讀	了解更多
      1 www	googletagmanager	com
      1 TXLD77	為提供您更多優質的內容	本網站使用cookies分析技術
      1 Submit	搜尋	天下全閱讀
      1 Store	google	play
      1 Social_popup	idDfp	div
      1 RSS	下載天下雜誌APP	App
      1 QRcode	apple_itunes_app	google_play
      1 popup_dfp	channel	Social_popup
      1 plus	轉寄	開關分享區
      1 play	關於天下雜誌群	顧客服務
      1 PDF下載	付費閱讀	下一篇
      1 ns	html	id
      1 LINE	RSS	下載天下雜誌APP
      1 LINE	icon	file
      1 LINE	google	plus
      1 IFRAME	www	googletagmanager
      1 IFRAME	popup_dfp	channel
      1 idDfp	div	gpt
      1 id	GTM	TXLD77
      1 icon	LINE	icon
      1 icon	google	icon
      1 icon	file	幻燈片上一頁
      1 icon	facebook	icon
      1 html	id	GTM
      1 GTM	TXLD77	為提供您更多優質的內容
      1 gpt	ad	1437128085953
      1 googletagmanager	com	ns
      1 google_play	雜誌訂閱	國際書展
      1 google	plus	轉寄
      1 google	play	關於天下雜誌群
      1 google	LINE	RSS
      1 google	icon	LINE
      1 file	幻燈片上一頁	幻燈片下一頁
      1 facebook	icon	google
      1 facebook	google	LINE
      1 English	天下全閱讀	免費下載App
      1 English	icon	facebook
      1 div	gpt	ad
      1 DEL	點數不足	付費閱讀將扣除10點
      1 DEL	付費閱讀將扣除10點	是否繼續
      1 cwlogo	切換側邊選單	搜尋
      1 CSR	天下	獨立評論
      1 copyright	2019天下雜誌	
      1 cookies	關於更多cookies資訊請閱讀我們的隱私權政策與使用條款	我知道了
      1 com	ns	html
      1 channel	Social_popup	idDfp
      1 apple_itunes_app	google_play	雜誌訂閱
      1 App	Store	google
      1 ad	1437128085953	10
      1 6048	服務時間	週一
      1 5	DEL	點
      1 48353	分享	LINE
      1 4250	DEL	點
      1 30	台北市104南京東路二段139號11樓	copyright
      1 2662	6048	服務時間
      1 2662	0332	傳真電話
      1 26	調整字體尺寸	透過橫跨1980至2013年
      1 2019天下雜誌		
      1 2018教育特刊專輯	雜誌	特色頻道
      1 2017	05	26
      1 2016年通過的哥倫比亞等國家	都稱不上是高度發展的國家	該國通過法案之年度的人均GDP
      1 2016	年一位義大利神父指稱義大利北方發生的地震是上帝對同性婚姻合法化的懲罰	美國的某位基督教領袖也公開宣稱
      1 2014年馬政府執政時期	法務部報告內容指出	同性婚姻恐衝擊現有婚姻制度
      1 2013年通過法案的巴西和巴拉圭	2016年通過的哥倫比亞等國家	都稱不上是高度發展的國家
      1 2012	年12	月立法院尤美女委員在司法及法制委員會召開了第一場同性婚姻公聽會
      1 2010年通過	同性婚姻權的阿根廷	2013年通過法案的巴西和巴拉圭
      1 2	2662	6048
      1 2	2662	0332
      1 17	30	台北市104南京東路二段139號11樓
      1 1437128085953	10	頁尾
      1 137國的資料庫	看看同性婚姻合法化後的國家	社會歷經了怎麼樣的變化
      1 137國	時間區段則從1980至2013年	以固定效果模型
      1 12週優惠	一天5元	無限閱讀
      1 10	頁尾	社群分享
      1 09	00	17
      1 05	26	調整字體尺寸
      1 0332	傳真電話	886
      1 00	17	30
      1 0	新南向	時尚生活
      1 ____________________	Submit	搜尋
