      3 肠胃不好吃什么药	治疗肠胃的药物	肠胃不好吃什么药
      2 Jessie	J中国巡演	深圳站
      2 17	18	01
      2 08	23	10
      2 05	17	18
      2 ____________________________________________________________	____________________________________________________________	____________________________________________________________
      1 黑格尔在	法哲学原理	中指出
      1 黄骨鱼怎么炖汤好喝	高档红茶品牌有哪些	红茶的种类
      1 黄骨鱼怎么炖汤好喝	搭配紫苏超不错	黄骨鱼怎么炖汤好喝
      1 麦当劳免费送大脆鸡扒麦满分	速抢	麦当劳免费送大脆
      1 麦当劳免费送大脆	VEX机器人2018	2019赛季亚洲公开赛即将启动
      1 鹏城活动	演出资讯	优惠打折
      1 鸭肠怎么炒最好吃	加点姜会更入味	鸭肠怎么炒最好吃
      1 鸭肠怎么炒最好吃	加点姜会更	鱿鱼和什么一起炒好吃
      1 鸭肠怎么炒最好吃	加	鸭肠怎么炒最好吃
      1 鱿鱼和什么一起炒好吃	搭配西葫芦	辣炒香菇根的做法
      1 鱼缸能放在阳台吗	鱼缸放阳台注意事项	鱼缸能放在阳台吗
      1 鱼缸能放在阳台吗	鱼	卫生间异味如何去除
      1 鱼缸放阳台注意事项	鱼缸能放在阳台吗	鱼
      1 鱼缸什么形状好	养鱼风水禁忌	婴儿床怎么选购
      1 鱼	卫生间异味如何去除	卫生间除臭技巧
      1 高等教育	管理	MBA
      1 高等	学车	驾校
      1 高档红茶品牌有哪些	红茶的种类	高档红茶品牌有哪些
      1 高档红茶品牌有哪些	妇科病吃什么食物好	11种食物帮女人搞定妇科病
      1 高分好听的名字推荐	别姓男孩取名	二字好听的名字精选
      1 驾驶证换证在哪里办	驾驶证到期	汽车轮胎为什么是黑色的
      1 驾驶证到期	汽车轮胎为什么是黑色的	汽车轮胎为什么是黑
      1 驾驶技巧	学车视频	深圳驾校
      1 驾校	学车	购车
      1 驾校	学车	学车指南
      1 马基在接受有线新闻网的采访时表示	几千年以来	人类文化都是将婚姻视为男女间的结合
      1 香蜜沉沉烬如霜分剧情介绍	61	63集
      1 首选品牌	粤ICP备08039997号	1
      1 饮食资讯	休闲	娱乐
      1 餐厅风水知识	什么户型的房子不能买	买房风水注意事项
      1 餐厅灯饰风水要注意什么	餐厅风水知识	什么户型的房子不能买
      1 食物营养	美味厨房	女性健康饮食
      1 食材	健康	医疗
      1 风水	图片	教育
      1 音乐见闻	医疗	健康
      1 韭菜炒油豆皮的做法	加点生姜会更	蒜香芹菜叶的做法
      1 陕西5a景区排名	2018陕西5a景区有哪些	去日本北海道旅游的最佳时间
      1 阴阳相调	是中国传统的哲学观念	很大程度上说
      1 长期以来人们都遵循着一男一女互相结合的婚姻定义	五大法学家之一的	莫德斯体努斯对婚姻所下的定义称
      1 银行	地铁	电费
      1 那姓女孩取名	这些名字超不错	那姓女孩取名
      1 那姓女孩取名	这些名	哈姓男孩取名
      1 避孕药有哪些	各种避孕药的用法用	相关资讯
      1 造成中国男女比例失调的原因是什么	造成中国男女比例失	造成中国男女比例失调的原因
      1 造成中国男女比例失调的原因	世界上女多男少的国家有哪些	2018中国男女比例是多少
      1 造成中国男女比例失	造成中国男女比例失调的原因	世界上女多男少的国家有哪些
      1 速抢	麦当劳免费送大脆鸡扒麦满分	速抢
      1 速抢	麦当劳免费送大脆	VEX机器人2018
      1 适合在婚礼放的韩	如何选购水龙头	水龙头选购技巧
      1 送给老公简单暖心的话语	对老公说的温暖的话	送给老公简单暖心的
      1 送给老公简单暖心的	2018结婚新郎保证书搞笑版范文	2018结婚新郎保证书搞
      1 迪拜最有钱的	2018福布斯亚洲富豪排行榜	2018世界各国人口密度排名
      1 迪拜十大富豪排行榜	迪拜最有钱的	2018福布斯亚洲富豪排行榜
      1 这种状况依然存在	智行基金会在对2600多名同性恋者的问卷调查中显示	57
      1 这样的数字与欧美国家动辄过半的同性恋支持率相差甚远	早在2002年	李银河教授就指出
      1 这是婚姻区别于其他社会关系的重要特征	回归到中国社会	从古至今中华民族都是在男女结合的婚姻制度下繁衍的
      1 这几款值得	冬瓜怎么做给宝宝吃好	这些吃法超
      1 这些营养吃法超不错	猪蹄怎么做给宝宝好	竹笋怎么做给宝宝吃好
      1 这些地方没去过就不算到过深圳	深圳暑假怎么玩	这些
      1 这些名字超好听	空心菜怎么做给宝宝吃好	宝妈必读文章
      1 这些名字超唯美	芹菜怎么做给宝宝吃	推荐这些吃法
      1 这些名字超不错	那姓女孩取名	这些名
      1 这些名字超不错	辜姓女孩取名	这些名
      1 这些名字真心不错	祖姓女孩取名	这些名字超好听
      1 这些名	红枣奶香玉米面发糕的做法	味道香甜回味无穷
      1 这些名	哈姓男孩取名	三字好听的名字
      1 这些吃法适合宝宝	竹笋怎么做给宝宝吃	辜姓女孩取名
      1 这些吃法超	那姓女孩取名	这些名字超不错
      1 这些吃法超	豌豆怎么做给宝宝吃好	这些吃法超
      1 这些	2018曲靖9月份好玩的地方大全	2018广元9月份好玩的地方大全
      1 这也说明了在计划生育的今天	正常的婚姻承载一个家族传宗接代的愿望	笔者认为
      1 还应该考虑其他因素	笔者认为	婚姻家庭有着鲜明的伦理性和民族特色
      1 近日	美国同性婚姻合法化让很多中国的男同女同们看到了希望	但同时也在质疑
      1 辣炒香菇根的做法	人见人爱的下饭	排骨怎么做好吃又简单
      1 辜姓女孩取名	这些名字超不错	辜姓女孩取名
      1 辜姓女孩取名	这些名	红枣奶香玉米面发糕的做法
      1 起诉离婚流程	休闲深圳	演出
      1 赞美老师的话语	2018教师节贺卡祝福语	中国34省市面积排名
      1 资讯	深圳医疗	外科
      1 资讯	内科	妇科
      1 购车指南	汽车养护	母婴
      1 购车	母婴	孕前
      1 豪车和普通车的区别有哪些	豪车和普通车的区别	开车听什么歌曲更提神
      1 豪车和普通车的区别	开车听什么歌曲更提神	开车听着提神的歌曲推荐
      1 豌豆怎么做给宝宝吃好	这些吃法超	那姓女孩取名
      1 豆瓣网	QQ好友	上一篇
      1 说	男曰婚	女曰姻
      1 诉讼离婚的法定条件	2018诉讼离婚需要什	旅游
      1 诉讼离婚的法	2018起诉离婚程序	起诉离婚流程
      1 评论	图说新闻	2018离婚补偿的条件
      1 设计培训	驾校	学车
      1 解梦	女性	范文
      1 解析阑尾炎的位置在身体的哪个部位	解析阑尾炎的位置在身	治疗痔疮的药物有哪些
      1 解析阑尾炎的位置在身	治疗痔疮的药物有哪些	得了痔疮吃什么药
      1 要美丽一整天	婚礼当天新娘注意事	送给老公简单暖心的话语
      1 西药大全	中药大全	政策考试
      1 装饰	风水	图片
      1 装修设计	装修图片	时尚装饰
      1 装修日记	装修宝典	行业动态
      1 装修宝典	行业动态	教育
      1 装修图片	时尚装饰	家居风水
      1 装修	装修设计	装修图片
      1 装修	培训	学车
      1 补血的药物有哪些	治疗妇科疾病的药物有哪些	妇科用药
      1 行业动态	教育	培训
      1 蟛蜞菊的药用	薄荷油的功效与作用	薄荷油的制法
      1 蟛蜞菊的功效与作用	蟛蜞菊的药用	薄荷油的功效与作用
      1 虽然如今可以通过人工授精等高科技手段	实现生	育子女的目的
      1 虽然	社会大众对同性恋产生了普遍的宽容	但在广大农村
      1 薏苡仁是薏米吗	感冒吃什么药	治疗感冒的药物有哪些
      1 薏苡仁和薏米有区别吗	薏苡仁是薏米吗	感冒吃什么药
      1 薄荷油的功效与作用	薄荷油的制法	薄荷油的功效与作用
      1 薄荷油的功效与作用	薄荷油的制法	拔牙前要做好哪些准备
      1 薄荷油的功效与作用	曼陀罗的功效与作用	曼陀罗附
      1 薄荷油的制法	薄荷油的功效与作用	曼陀罗的功效与作用
      1 薄荷油的制法	拔牙前要做好哪些准备	拔牙后要注
      1 蒜香芹菜叶的做法	淋上香油会更入	鸭肠怎么炒最好吃
      1 蒋聘婷否认刘强东性侵案女	刘强东性侵案新进展	巨齿鲨主题曲是什么
      1 蒋聘婷否认刘	巨齿鲨主题曲是什么	爱拯救世界歌
      1 葡萄牙民法典	第1577	条则规定
      1 萧敬腾2018巡回演唱会	安室奈美惠巡回告别演唱会深圳站介绍	安室奈美惠巡回告别演
      1 萧敬腾2018巡回演唱会	娱乐先生深圳站介绍	萧敬腾2018巡回演唱会
      1 营养	美食	深圳饮食大全
      1 菜谱	食材	健康
      1 莫德斯体努斯对婚姻所下的定义称	婚姻是一夫一妻的终身结合	神事和人事的共同关系
      1 范文	主页	深圳结婚
      1 芹菜怎么做给宝宝吃	推荐这些吃法	哪些包子馅适合宝宝吃
      1 节气门清洗一次多少钱	节气门一般多久清	2018车载歌曲哪些好听
      1 节气门一般多久清	2018车载歌曲哪些好听	2018好听的车载歌曲
      1 色泽美观回味	韭菜炒油豆皮的做法	加点生姜会更
      1 舌头溃疡怎么办	治疗舌头溃疡小妙招	肠胃不好吃什么药
      1 臭梧桐根的功效与作用	精神病和神经病有什么区别	精神病与神经病介绍
      1 腹部疼痛详细位置	薏苡仁和薏米有区别吗	薏苡仁是薏米吗
      1 腹部疼痛详细位置	右下腹隐痛的原因是什	感冒吃什么药
      1 腹部疼痛详细位置	右下腹隐痛的原因是	右下腹隐痛的原因是什么
      1 腹部	哪些人不适合拔牙	不宜拔牙的十类
      1 脆皮烤五花肉的做法	色泽美观回味	韭菜炒油豆皮的做法
      1 肿瘤	传染科	急诊
      1 育子女的目的	但过于依赖物质化	无法体现生育的人文价值
      1 肯定是婚姻伦理更为重要	因为同性恋者的权利不一定要通过法律来保护	但传统的婚姻伦理一旦被否
      1 肠胃不好吃什么药	治疗肠胃的药物有哪些	吃什么药可以补血
      1 肠胃不好吃什么药	治疗	人的心率正常范围是多少
      1 肠胃不好吃什么药	治	各种避孕药的用法用量介绍
      1 职业培训	外语培训	电脑培训
      1 而通往婚姻其他道路一直都被阻塞	正如黑格尔所说	婚姻不单单只是关注性的关系和自然属性
      1 而立法则会对一个国家和民族的观念产生最根本性的影响	中国的婚姻观念和家庭伦理与同	性恋者的权利保护到底孰轻孰重
      1 而不能接受的占到91	89	这样的数字与欧美国家动辄过半的同性恋支持率相差甚远
      1 而下以继后世也	我国著名社会学家费孝通在论及婚姻的本质时就曾经	指出
      1 而	葡萄牙民法典	第1577
      1 老人健康饮食	饮食资讯	休闲
      1 美食	深圳饮食大全	食物营养
      1 美食	深圳	菜谱
      1 美食	学车	健康
      1 美缝剂如何	家用中央空调怎么挑选	优缺点是什
      1 美缝剂什么牌子好	美缝剂如何	家用中央空调怎么挑选
      1 美国家庭研究理事会的康妮	马基在接受有线新闻网的采访时表示	几千年以来
      1 美国同性婚姻合法化让很多中国的男同女同们看到了希望	但同时也在质疑	中国同性婚姻合法化到底还需要多久
      1 美国众议院于1996年7月通过的	捍卫婚姻法	法案
      1 美味厨房	女性健康饮食	男性健康饮食
      1 罗马法学家莫蒂迪斯蒂努斯指出	婚姻者	乃一夫一妻之终身结合
      1 网络设备	深圳IT	数码产品
      1 网站地图	法律声明	挑错有礼
      1 缓解低烧的办法	左下腹部隐痛的原因	人体左腹部是什么器官
      1 继血统	承祭祀	美国家庭研究理事会的康妮
      1 结婚年龄至少20岁解析	独生子女证明范本	单方起诉离婚的程序步骤介绍
      1 结婚	家居	教育
      1 结婚	婚礼策划	喜宴酒店
      1 结婚	婚照	策划
      1 约定以永久共处的方式来共同担负抚育子女的责任	传宗接代	是中国家庭的重要功能
      1 红茶的种类	高档红茶品牌有哪些	妇科病吃什么食物好
      1 红枣奶香玉米面发糕的做法	味道香甜回味无穷	红枣奶香玉米面发糕
      1 红枣奶香玉米面发糕的做法	味道香	脆皮烤五花肉的做法
      1 红枣奶香玉米面发糕	南瓜怎么做面包好吃	加入鸡蛋
      1 红姓男孩取名	高分好听的名字推荐	别姓男孩取名
      1 繁衍种族的自然法则	抹杀了传统观念中阴阳两性之间质的差别	从根本上影响中国传统家庭的和谐
      1 繁殖后代	实现人类自身再生产的单元	同性婚姻不能确保人类的传宗接代
      1 精神病和神经病有什么区别	精神病与神经病介绍	精神病和神经病有什
      1 精神病和神经病有什	治疗妇科疾病的药物有哪些	妇科用药
      1 精神病与神经病介绍	精神病和神经病有什	治疗妇科疾病的药物有哪些
      1 精神心理	肿瘤	传染科
      1 粤公网安备	44030302000083号	wc
      1 粤ICP备08039997号	1	粤公网安备
      1 管理	MBA	文艺
      1 策划	婚法	家居
      1 答案可能要让很多人失望了	因	为目前同性婚姻合法化在中国是行不通的
      1 第1577	条则规定	婚姻是两个异性的人之间根据本法典的规定
      1 笔记本	手机	平板电脑
      1 笔者认为	法律的规定代表着的对某一种行为或现象的社会评价	而立法则会对一个国家和民族的观念产生最根本性的影响
      1 笔者认为	婚姻是养育子女	繁殖后代
      1 笔者认为	婚姻家庭有着鲜明的伦理性和民族特色	与一个国家的历史
      1 竹笋怎么做给宝宝吃好	这些吃法适合宝宝	竹笋怎么做给宝宝吃
      1 竹笋怎么做给宝宝吃	辜姓女孩取名	这些名字超不错
      1 立法者对一国传统与国情的视而不见	必然要付出巨大的代价	共2页
      1 空心菜怎么做给宝宝吃好	宝妈必读文章	空心菜怎么做给宝宝
      1 空心菜怎么做给宝宝	猪蹄怎么做给宝宝好吃	这些营养吃法超不错
      1 移民	家教	设计培训
      1 称	婚姻是一男一女以永续共同生活为目的的结	合
      1 科技	笔记本	手机
      1 私人的东西	他与公共利益密切相关	法律当然需要保护弱势群体的利
      1 离婚补偿要满足的条件	2018离婚补偿的条件	2018孕妇离婚有些什么补偿
      1 离婚补偿要满足的条	2018孕妇离婚有些什么补偿	2018年婚姻法离婚最新规定
      1 离婚补偿要满足	2018孕妇离婚有些什么补偿	2018年婚姻法离婚最新规定
      1 离婚时需要带什么证件	女方离婚起诉书范本	新版离婚证样本图片
      1 离婚后女方户口处	二胎产假国家规定	二胎产假有多少天
      1 离婚买房相关法律	2018年12月23日结婚好不好	12月23日适合结婚
      1 神经科药物有哪些	治疗气管炎的药物有哪些	气管炎吃什么药
      1 神经性头痛吃什么药	神经科药物有哪些	治疗气管炎的药物有哪些
      1 神事和人事的共同关系	优帝	法学纲要
      1 祖姓男孩取名	这些名字真心不错	祖姓女孩取名
      1 祖姓女孩取名	这些名字超好听	空心菜怎么做给宝宝吃好
      1 社保	银行	地铁
      1 社会大众对同性恋产生了普遍的宽容	但在广大农村	中小城市
      1 礼记经解	说	男曰婚
      1 礼记昏义	中说	婚姻者
      1 真皮沙发选购	梳妆台摆放位置	梳妆台摆放风水禁
      1 真皮沙发什么品牌好	真皮沙发选购	梳妆台摆放位置
      1 相关阅读	2018年婚姻法离婚最新规定2018	09
      1 相关资讯	2018家暴离婚需要什么证据	2018家暴离婚需要什么证
      1 目的在于生男育女	继血统	承祭祀
      1 益	然而法律绝不是立法者意志和理性化的产物	立法者对一国传统与国情的视而不见
      1 皮肤性病	精神心理	肿瘤
      1 的话	婚姻制度很可能随之瓦解	无论你是否愿意承认
      1 的解释说	婚姻者何谓	昏时行礼
      1 的同性恋者表示一定不会结婚	这也说明了在计划生育的今天	正常的婚姻承载一个家族传宗接代的愿望
      1 的同性恋者已经或将要接受异性婚姻	只有25	0
      1 百度贴吧	新浪微博	人人网
      1 白虎通	的解释说	婚姻者何谓
      1 登录	注册	侵权投诉
      1 留学	移民	家教
      1 男科药物功能主治介绍	男科用药大全	男科药物功能主治介绍
      1 男科药物功能主治介绍	男科用药大全	如何延长做爱时间
      1 男科药物功能主治介绍	如何延长做爱时间	延长性爱时间的5个方法
      1 男科用药大全	男科药物功能主治介绍	如何延长做爱时间
      1 男科用药大全	如何延长做爱时间	延长性爱时间的5个方法
      1 男科	右下腹隐痛的原因是什么	腹部疼痛详细位置
      1 男科	五官科	皮肤性病
      1 男曰婚	女曰姻	尔雅释亲
      1 男性健康饮食	儿童健康饮食	老人健康饮食
      1 男性保健品有哪些	十大男性保健品排行榜	男人气虚的症状有哪些
      1 男女比例失	迪拜十大富豪排行榜	迪拜最有钱的
      1 男士裤子尺码对照表	图文详解说明	男士裤子尺码对照表
      1 男士裤子尺码对照表	保暖内衣什么牌子好	2018保暖内衣品牌推荐
      1 男士洗面奶十大排行	热点排行	离婚时需要带什么证件
      1 男士洗面奶十大排行	好用的男士洗面奶推荐	男士洗面奶十大排行
      1 男人气虚的症状有哪些	男人气虚怎么补才好	壮阳药排行榜10强
      1 男人气虚怎么补才好	壮阳药排行榜10强	口碑最好的壮阳药
      1 男人吃生姜的好处	哪些人不能吃姜	男人吃生姜的好处
      1 男人吃生姜的好处	哪	黄骨鱼怎么炖汤好喝
      1 电费	专题	星座
      1 电视背景墙用什么材料好	2018雅加达亚运会所有项目金牌总数	2018秋季开学典礼校长发言致辞四篇
      1 电视综艺	明星名人	音乐见闻
      1 电脑培训	高等教育	管理
      1 电影大片	电视综艺	明星名人
      1 由此可见	同性相吸	异性相斥
      1 由此可见	从婚姻伦理是从人类的自然属性出发的	是男女两性的自然生理的结合
      1 用以结合男女为夫妇	在社会承认下	约定以永久共处的方式来共同担负抚育子女的责任
      1 生活时尚	电影大片	电视综艺
      1 生活指南	投稿	登录
      1 生儿育女的观念仍然相当浓烈	中国同性婚姻合法化诉求的出现	并不表明中国传统婚姻观念已经发生巨大的变革
      1 甚至在大城市传统婚姻传宗接代	生儿育女的观念仍然相当浓烈	中国同性婚姻合法化诉求的出现
      1 瓷砖旧了怎么办	瓷砖怎么翻新	梳妆台摆放禁忌有哪些
      1 瓷砖怎么翻新	梳妆台摆放禁忌有哪些	梳妆台如何摆放
      1 珠宝钻戒	婚纱礼服	婚礼音乐
      1 猪蹄怎么做给宝宝好吃	这些营养吃法超不错	猪蹄怎么做给宝宝好
      1 猪蹄怎么做给宝宝好	竹笋怎么做给宝宝吃好	这些吃法适合宝宝
      1 独生子女证明范本	单方起诉离婚的程序步骤介绍	热门关注
      1 爱拯救世界歌词介绍	巨齿鲨主题曲是什么	刘强东已经回国
      1 爱拯救世界歌	斗破苍穹爱情主题曲是什么	主题曲
      1 照片差不	口红王子中国版综艺嘉宾介绍	香蜜沉沉烬如霜分剧情介绍
      1 然而法律绝不是立法者意志和理性化的产物	立法者对一国传统与国情的视而不见	必然要付出巨大的代价
      1 热门关注	婚庆	装修
      1 热点排行	离婚时需要带什么证件	女方离婚起诉书范本
      1 灶台朝向风水	搬家有什么讲究	搬家风水禁忌有哪些
      1 潮派牛肉火锅5折特惠速抢攻略介绍	潮派牛肉火锅5折特惠速	55分身材的赵丽颖
      1 潮派牛肉火锅5折特惠速	55分身材的赵丽颖	完美穿衣超显腿长
      1 演出资讯	优惠打折	生活时尚
      1 演出	旅游	深圳
      1 演出	户外	折扣
      1 游记见闻	图行天下	我要
      1 游戏玩家	关于我们	网站地图
      1 港澳旅游	国内旅游	出境旅游
      1 港澳	结婚	婚照
      1 深圳驾驶证换证方法	深圳驾驶证到期了怎	底盘装甲什么材质的好
      1 深圳驾驶证到期了怎么换证	深圳驾驶证换证方法	深圳驾驶证到期了怎
      1 深圳驾驶证到期了怎么换证	深圳	换驾驶证需要什么材料
      1 深圳驾驶证到期了怎	底盘装甲什么材质的好	底盘装
      1 深圳驾校	深圳车讯	购车指南
      1 深圳饮食大全	食物营养	美味厨房
      1 深圳野生动物园终于降价了	五折特惠	深圳野生动物
      1 深圳野生动物	深圳世界之窗69	9元通玩
      1 深圳车讯	购车指南	汽车养护
      1 深圳结婚	婚姻法	同性婚姻合法化在中国行
      1 深圳站	殿堂级诗人阿多尼斯专题讲座免费领票	殿堂级诗人阿多尼斯专
      1 深圳站	Jessie	J中国巡演
      1 深圳科目三考场有哪些	深圳科目	深圳驾驶证到期了怎么换证
      1 深圳科目	深圳驾驶证到期了怎么换证	深圳
      1 深圳暑假怎么玩	这些地方没去过就不算到过深圳	深圳暑假怎么玩
      1 深圳暑假怎么玩	这些	2018曲靖9月份好玩的地方大全
      1 深圳旅游	周边旅游	港澳旅游
      1 深圳地图	深圳公交	商户搜索
      1 深圳周边赏花的地方	2018陕西5a景区有哪些	陕西5a景区排名
      1 深圳周边赏花的地方	2018深圳赏花攻略	深圳周边赏花的地方
      1 深圳医疗	外科	内科
      1 深圳公交	商户搜索	常用查询
      1 深圳中心书城公益文化活动周	井柏然回怼粉丝diss工作室	照片差不
      1 深圳世界之窗69	9元通玩	带宝贝周游世界吧
      1 深圳世界之窗69	9元通玩	69
      1 深圳IT	数码产品	游戏玩家
      1 深圳	菜谱	食材
      1 深圳	旅游	旅游资讯
      1 深圳	换驾驶证需要什么材料	到期换驾
      1 深圳	周边	港澳
      1 淋上香油会更入	鸭肠怎么炒最好吃	加点姜会更入味
      1 海带食用禁忌	舌头溃疡怎么办	治疗舌头溃疡小妙招
      1 海带适宜及禁忌人群	海带食用禁忌	舌头溃疡怎么办
      1 泰式装修风格特点有哪些	泰式装修设计要点	泰式装修风格特点有
      1 泰式装修风格特点有	造成中国男女比例失调的原因是什么	造成中国男女比例失
      1 泰式装修设计要点	泰式装修风格特点有	造成中国男女比例失调的原因是什么
      1 注册	侵权投诉	娱乐
      1 法案	上规定的	婚姻概念是
      1 法律的规定代表着的对某一种行为或现象的社会评价	而立法则会对一个国家和民族的观念产生最根本性的影响	中国的婚姻观念和家庭伦理与同
      1 法律当然需要保护弱势群体的利	益	然而法律绝不是立法者意志和理性化的产物
      1 法律尤其是婚姻家庭法是一国传统伦理道德和传统文化沉积的产物	如果什么样的自愿结合都可以成为	婚姻
      1 法律声明	挑错有礼	chachaba
      1 法学纲要	称	婚姻是一男一女以永续共同生活为目的的结
      1 法哲学原理	中指出	婚姻关系实质上是伦理关系
      1 治疗风湿病的药物有哪些	治疗风湿病的药	伤口化脓怎么处理
      1 治疗风湿病的药	伤口化脓怎么处理	介绍几种正确的处理方法
      1 治疗舌头溃疡小妙招	肠胃不好吃什么药	治疗肠胃的药物
      1 治疗肠胃的药物有哪些	吃什么药可以补血	补血的药物有哪些
      1 治疗肠胃的药物	肠胃不好吃什么药	治疗肠胃的药物有哪些
      1 治疗肠胃的药物	肠胃不好吃什么药	治疗
      1 治疗肠胃的药物	肠胃不好吃什么药	治
      1 治疗痔疮的药物有哪些	得了痔疮吃什么药	治疗风湿病的药物有哪些
      1 治疗气管炎的药物有哪些	气管炎吃什么药	肠胃不好吃什么药
      1 治疗感冒的药物有哪些	海带适宜及禁忌人群	海带食用禁忌
      1 治疗感冒的药物有哪些	感冒吃什么药	治疗感冒
      1 治疗感冒	右下腹隐痛的原因是什么	腹部疼痛详细位置
      1 治疗妇科疾病的药物有哪些	妇科用药	治疗妇科疾病的药物有
      1 治疗妇科疾病的药物有哪些	妇科用药	治疗妇科疾病的药物
      1 治疗妇科疾病的药物有哪些	妇科用药	不孕不育吃什么药好
      1 治疗妇科疾病的药物有	不孕不育吃什么药好	治疗不孕不育的药物
      1 治疗妇科疾病的药物	肠胃不好吃什么药	治疗肠胃的药物
      1 治疗乳腺疾病的药物有哪些	治疗妇科疾病的药物有哪些	妇科用药
      1 治疗不孕不育的药物	孕妇能吃月饼吗	孕妇吃月饼要注意些什么
      1 治疗不孕不育的药物	不孕不育吃什么药好	治疗乳腺疾病的药物有哪些
      1 治疗	人的心率正常范围是多少	标准心率值是多少
      1 治	各种避孕药的用法用量介绍	避孕药有哪些
      1 沙发床选购注意事项	沙发床什么品牌的好	鱼缸什么形状好
      1 沙发床什么品牌的好	鱼缸什么形状好	养鱼风水禁忌
      1 沙发床什么品牌的好	沙发床选购注意事项	沙发床什么品牌的好
      1 汽车轮胎为什么是黑色的	汽车轮胎为什么是黑	开封机油如何保存
      1 汽车轮胎为什么是黑	开封机油如何保存	开封机油的保存方法介绍
      1 汽车的常见易损	汽车底盘易损件有哪些	汽车底盘易
      1 汽车易损件有哪些	汽车的常见易损	汽车底盘易损件有哪些
      1 汽车底盘配件	十万落地的家用车哪款好	十万落地的家用车推荐
      1 汽车底盘易损件有哪些	汽车底盘易	汽车底盘件包括哪些
      1 汽车底盘易	汽车底盘件包括哪些	汽车底盘配件
      1 汽车底盘封塑多少钱	汽车底盘封塑	汽车易损件有哪些
      1 汽车底盘封塑	汽车易损件有哪些	汽车的常见易损
      1 汽车底盘件包括哪些	汽车底盘配件	十万落地的家用车哪款好
      1 汽车刹车灯不亮解	2018科目三考试合格标准介绍	2018年淮安有什么好玩的地方
      1 汽车养护	母婴	健康
      1 水龙头选购技巧	墙壁发霉怎么处理	墙壁发霉预防措施
      1 气管炎吃什么药	肠胃不好吃什么药	治疗肠胃的药物
      1 母婴用品	新生儿	婴儿期
      1 母婴	美食	学车
      1 母婴	孕前	孕妇
      1 母婴	健康	准备怀孕
      1 殿堂级诗人阿多尼斯专题讲座免费领票	殿堂级诗人阿多尼斯专	速抢
      1 殿堂级诗人阿多尼斯专题讲座免费领票	殿堂级诗人阿多尼斯	深圳中心书城公益文化活动周
      1 殿堂级诗人阿多尼斯专	速抢	麦当劳免费送大脆鸡扒麦满分
      1 殿堂级诗人阿多尼斯	深圳中心书城公益文化活动周	井柏然回怼粉丝diss工作室
      1 正常的婚姻承载一个家族传宗接代的愿望	笔者认为	婚姻是养育子女
      1 正如黑格尔所说	婚姻不单单只是关注性的关系和自然属性	还应该考虑其他因素
      1 榻榻米选购注意	厨房灶台风水禁忌	灶台朝向风水
      1 榻榻米什么品牌好	榻榻米选购注意	厨房灶台风水禁忌
      1 梳妆台摆放风水禁	客厅空调摆放位置	客厅空调风水
      1 梳妆台摆放禁忌有哪些	梳妆台如何摆放	电视背景墙用什么材料好
      1 梳妆台摆放位置	梳妆台摆放风水禁	客厅空调摆放位置
      1 梳妆台如何摆放	电视背景墙用什么材料好	2018雅加达亚运会所有项目金牌总数
      1 桂林旅游行程如何安排	2018广西桂林旅游攻略	2018香港10月份好玩的地方大全
      1 标准心率值是多少	人的心率正常范围是多	神经性头痛吃什么药
      1 查询	社保	银行
      1 查查吧	www	chachaba
      1 来自星星的塞勒公益演出介绍	春茧儿童剧场	来自星星
      1 来自星星	五折特惠	深圳野生动物园终于降价了
      1 条则规定	婚姻是两个异性的人之间根据本法典的规定	意在以完全共同生活的方式建立家庭而订立的合同
      1 李银河教授就指出	中国的同性恋者和西方的最大区别就是大多数人会选择与异性结	婚
      1 朱尖的	2015	07
      1 本地生活	首选品牌	粤ICP备08039997号
      1 有学者在农村调查中发现能够接受子女为同性恋的仅为8	1	而不能接受的占到91
      1 最大166万平方公里	中国34省市面积排名	殿堂级诗人阿多尼斯专题讲座免费领票
      1 曼陀罗附	薄荷油的功效与作用	薄荷油的制法
      1 曼陀罗的功效与作用	曼陀罗附	薄荷油的功效与作用
      1 智行基金会在对2600多名同性恋者的问卷调查中显示	57	3
      1 是社会伦理的重要体现	世界各国不管信仰如何	长期以来人们都遵循着一男一女互相结合的婚姻定义
      1 是男女两性的自然生理的结合	一个的合法婚姻首先应该肯定婚姻的自然属性	如两性的生理差别
      1 是中国家庭的重要功能	有学者在农村调查中发现能够接受子女为同性恋的仅为8	1
      1 是中国传统的哲学观念	很大程度上说	中国对于婚姻伦理的重视是中华民族得以世世代代繁衍不息
      1 是中华民族对性的完美表达	笔者认为	法律的规定代表着的对某一种行为或现象的社会评价
      1 是两性关系的结合	是中华民族对性的完美表达	笔者认为
      1 春茧儿童剧场	来自星星的塞勒公益演出介绍	春茧儿童剧场
      1 春茧儿童剧场	来自星星	五折特惠
      1 星座	解梦	女性
      1 昏时行礼	故曰婚	妇人因夫而
      1 明星名人	音乐见闻	医疗
      1 明不断的重要因素	中国人长期认可的婚姻关系是指男女通过结婚所形成的夫妻关系	是两性关系的结合
      1 时尚装饰	家居风水	装修日记
      1 时尚	你看起来好像很好吃童话剧演出深圳站介绍	你看起来好像很好吃童
      1 早在2002年	李银河教授就指出	中国的同性恋者和西方的最大区别就是大多数人会选择与异性结
      1 无论你是否愿意承认	婚姻制度本身并不是一个完全	私人的东西
      1 无法体现生育的人文价值	从现实意义上讲	很难获得中华民族的认可
      1 旅游路线	深圳旅游	周边旅游
      1 旅游资讯	旅游路线	深圳旅游
      1 旅游	结婚	家居
      1 旅游	深圳	周边
      1 旅游	旅游资讯	旅游路线
      1 旅游	2018年离婚买房新政策	离婚买房相关法律
      1 新生儿	婴儿期	幼儿期
      1 新生	美食	深圳
      1 新版离婚证样本图片	2018年全国各地婚假规定一览表	夫妻离婚后户口怎么办
      1 新浪微博	人人网	豆瓣网
      1 新婚姻法关于房产的规定2018	05	17
      1 新婚姻法关于房产的规定	2018最新规定	新婚姻法18岁结婚
      1 新婚姻法2018关于房产	新婚姻法关于房产的规定2018	05
      1 新婚姻法18岁结婚	结婚年龄至少20岁解析	独生子女证明范本
      1 新娘美甲图片2018款式	2018有刘海的新娘发型图片	2019年1月27日结婚好吗
      1 新娘美容	度蜜月	婚姻资讯
      1 斗破苍穹爱情主题曲是什么	主题曲	你看起来好像很好吃童话剧演出深圳站介绍
      1 文艺	体育	留学
      1 文化	与一个民族的思维方式	价值取向
      1 数码产品	游戏玩家	关于我们
      1 数码	科技	笔记本
      1 数字家电	办公设备	网络设备
      1 教育	婴幼	小中
      1 教育	娱乐	母婴
      1 教育	培训	学历教育
      1 故曰婚	妇人因夫而	成
      1 故曰姻	礼记经解	说
      1 政策考试	数码	科技
      1 搭配西葫芦	辣炒香菇根的做法	人见人爱的下饭
      1 搭配紫苏超不错	黄骨鱼怎么炖汤好喝	高档红茶品牌有哪些
      1 搬家风水禁忌有哪些	搬家有什么讲究	搬家
      1 搬家有什么讲究	搬家风水禁忌有哪些	搬家有什么讲究
      1 搬家有什么讲究	搬家	鱼缸能放在阳台吗
      1 搬家	鱼缸能放在阳台吗	鱼缸放阳台注意事项
      1 推荐这些吃法	哪些包子馅适合宝宝吃	这几款值得
      1 排骨怎么做好吃又简单	加点冰糖会	山药红豆糕的做法
      1 排卵试纸怎么看	伤口化脓怎么处理	介绍几种正确的处理方法
      1 换驾驶证需要什么材料	到期换驾	驾驶证换证在哪里办
      1 捍卫婚姻法	法案	上规定的
      1 挑错有礼	chachaba	com
      1 指出	婚姻是人为的仪式	用以结合男女为夫妇
      1 拔牙的并发症介绍	十大功劳的功效与作用	十大功劳叶
      1 拔牙有哪些危害	拔牙的并发症介绍	十大功劳的功效与作用
      1 拔牙后要注	五指毛桃的禁忌人群	哪些人不适合
      1 拔牙前要做好哪些准备	拔牙后要注	五指毛桃的禁忌人群
      1 抹杀了传统观念中阴阳两性之间质的差别	从根本上影响中国传统家庭的和谐	互补与满足
      1 折扣	时尚	你看起来好像很好吃童话剧演出深圳站介绍
      1 投稿	登录	注册
      1 承祭祀	美国家庭研究理事会的康妮	马基在接受有线新闻网的采访时表示
      1 打离婚官司多少钱2018	05	17
      1 打折	演出	旅游
      1 手机	平板电脑	台式机
      1 户籍	婚育	交通
      1 户外	折扣	时尚
      1 我要	结婚	婚礼策划
      1 我国著名社会学家费孝通在论及婚姻的本质时就曾经	指出	婚姻是人为的仪式
      1 成	故曰姻	礼记经解
      1 感冒吃什么药	治疗感冒的药物有哪些	海带适宜及禁忌人群
      1 感冒吃什么药	治疗感冒的药物有哪些	感冒吃什么药
      1 感冒吃什么药	治疗感冒	右下腹隐痛的原因是什么
      1 意在以完全共同生活的方式建立家庭而订立的合同	由此可见	从婚姻伦理是从人类的自然属性出发的
      1 性的本能	和种族的繁衍等	这是婚姻区别于其他社会关系的重要特征
      1 性恋者的权利保护到底孰轻孰重	从利益衡量的角度来说	肯定是婚姻伦理更为重要
      1 急诊	西药大全	中药大全
      1 急诊	中药	办事
      1 怀孕期	分娩期	产后护理
      1 必然要付出巨大的代价	共2页	上一页
      1 微信	百度贴吧	新浪微博
      1 得了痔疮吃什么药	治疗风湿病的药物有哪些	治疗风湿病的药
      1 很难获得中华民族的认可	虽然	社会大众对同性恋产生了普遍的宽容
      1 很大程度上说	中国对于婚姻伦理的重视是中华民族得以世世代代繁衍不息	历尽千古而文
      1 很多国家的婚姻法都规定了合法婚姻是没有血缘关系的一男一女之间的结合	例如	美国众议院于1996年7月通过的
      1 影像设备	数字家电	办公设备
      1 张三丰的神话故事	张三丰是谁	东汉和三国之间的区别
      1 张三丰是谁	东汉和三国之间的区别	东汉和三国之间的区
      1 异性相斥	阴阳相调	是中国传统的哲学观念
      1 开车扣6分的违法行	七八万小型suv哪款好	家用七八万小型su
      1 开车听着提神的歌曲推荐	开车听什么歌曲更提	右下腹隐痛的原因是什么
      1 开车听什么歌曲更提神	开车听着提神的歌曲推荐	开车听什么歌曲更提
      1 开车听什么歌曲更提	右下腹隐痛的原因是什么	腹部疼痛详细位置
      1 开封机油的保存方法介绍	开封机油如何保存	开
      1 开封机油如何保存	开封机油的保存方法介绍	开封机油如何保存
      1 开封机油如何保存	开	豪车和普通车的区别有哪些
      1 开	豪车和普通车的区别有哪些	豪车和普通车的区别
      1 延长性爱时间的5个方法	男性保健品有哪些	十大男性保健品排行榜
      1 延长性爱时间的5个方法	如何延长做爱时间	延长
      1 延长	男科药物功能主治介绍	男科用药大全
      1 度蜜月	婚姻资讯	婚姻法
      1 底盘装甲什么材质的好	底盘装	汽车底盘封塑多少钱
      1 底盘装	汽车底盘封塑多少钱	汽车底盘封塑
      1 广东国庆哪里	2018年松原8月份好玩的地方大全	2018张家界8月份好玩的地方大全
      1 幼儿期	学龄前	营养
      1 并不表明中国传统婚姻观念已经发生巨大的变革	法律尤其是婚姻家庭法是一国传统伦理道德和传统文化沉积的产物	如果什么样的自愿结合都可以成为
      1 平板电脑	台式机	影像设备
      1 常用查询	生活指南	投稿
      1 带宝贝周游世界吧	深圳世界之窗69	9元通玩
      1 巨齿鲨主题曲是什么	爱拯救世界歌词介绍	巨齿鲨主题曲是什么
      1 巨齿鲨主题曲是什么	爱拯救世界歌	斗破苍穹爱情主题曲是什么
      1 巨齿鲨主题曲是什么	刘强东已经回国	刘强东回国第一时间做了什么
      1 左下腹部隐痛的原因	人体左腹部是什么器官	男科药物功能主治介绍
      1 山药红豆糕的做法	人见人爱的美味	男人吃生姜的好处
      1 尔雅释亲	则说	婿之父为姻
      1 小中	高等	学车
      1 对老公说的温暖的话	送给老公简单暖心的	2018结婚新郎保证书搞笑版范文
      1 对于婚姻	白虎通	的解释说
      1 家用中央空调怎么挑选	优缺点是什	真皮沙发什么品牌好
      1 家用七八万小型su	刹车灯不亮是什么原因	汽车刹车灯不亮解
      1 家教	设计培训	驾校
      1 家庭的基本功能是繁衍后代	礼记昏义	中说
      1 家居风水	装修日记	装修宝典
      1 家居	装饰	风水
      1 家居	装修	装修设计
      1 家居	教育	娱乐
      1 客厅空调风水	沙发床什么品牌的好	沙发床选购注意事项
      1 客厅空调摆放位置	客厅空调风水	沙发床什么品牌的好
      1 审美趣味等都密切相关	因此	中国的同性婚姻问题首先不能回避的是中国家庭传宗接代的基本功能
      1 实现生	育子女的目的	但过于依赖物质化
      1 实现人类自身再生产的单元	同性婚姻不能确保人类的传宗接代	虽然如今可以通过人工授精等高科技手段
      1 实木地板清洁技巧	实木地板如何保养	餐厅灯饰风水要注意什么
      1 实木地板如何保养	餐厅灯饰风水要注意什么	餐厅风水知识
      1 宝妈必读文章	空心菜怎么做给宝宝	猪蹄怎么做给宝宝好吃
      1 定	会破坏男女相配	繁衍种族的自然法则
      1 完美穿衣超显腿长	55分身材的赵丽颖	完美
      1 完美	男士裤子尺码对照表	图文详解说明
      1 安室奈美惠巡回告别演唱会深圳站介绍	安室奈美惠巡回告别演	Jessie
      1 安室奈美惠巡回告别演	Jessie	J中国巡演
      1 它	只被看成一种性的关系	而通往婚姻其他道路一直都被阻塞
      1 学龄前	营养	美食
      1 学车视频	深圳驾校	深圳车讯
      1 学车指南	驾驶技巧	学车视频
      1 学车	驾校	学车
      1 学车	购车	母婴
      1 学车	旅游	2018年离婚买房新政策
      1 学车	学车指南	驾驶技巧
      1 学车	健康	2018广西桂林旅游攻略
      1 学历教育	中小学教育	婴幼儿教育
      1 孕妇能吃月饼吗	孕妇吃月饼要注意些什么	哪里可以买到排卵试纸
      1 孕妇吃月饼要注意些什么	哪里可以买到排卵试纸	排卵试纸怎么看
      1 孕妇	新生	美食
      1 孕前	孕妇	新生
      1 婿之父母相谓为婚姻	由此可见	同性相吸
      1 婿之父为姻	妇之父为婚	妇之父母
      1 婴幼儿教育	职业培训	外语培训
      1 婴幼	小中	高等
      1 婴儿期	幼儿期	学龄前
      1 婴儿床怎么选购	婴儿床使用方法	儿童房怎么装修好看
      1 婴儿床使用方法	儿童房怎么装修好看	儿童房装修注
      1 婚育	交通	查询
      1 婚纱礼服	婚礼音乐	新娘美容
      1 婚纱照	婚礼用品	珠宝钻戒
      1 婚礼音乐	新娘美容	度蜜月
      1 婚礼策划	喜宴酒店	婚纱照
      1 婚礼用品	珠宝钻戒	婚纱礼服
      1 婚礼当天新娘注意事项	要美丽一整天	婚礼当天新娘注意事
      1 婚礼当天新娘注意事	送给老公简单暖心的话语	对老公说的温暖的话
      1 婚照	策划	婚法
      1 婚法	家居	装饰
      1 婚庆	装修	培训
      1 婚姻资讯	婚姻法	家居
      1 婚姻者何谓	昏时行礼	故曰婚
      1 婚姻者	合二姓之好	上以事宗庙
      1 婚姻者	乃一夫一妻之终身结合	目的在于生男育女
      1 婚姻法	家居	装修
      1 婚姻法	同性婚姻合法化在中国行	同性婚姻合法化在中国行不通的四大原因
      1 婚姻概念是	一个男人和一个女人的结合	而
      1 婚姻是文明社会里最基本的单位	是社会伦理的重要体现	世界各国不管信仰如何
      1 婚姻是养育子女	繁殖后代	实现人类自身再生产的单元
      1 婚姻是人为的仪式	用以结合男女为夫妇	在社会承认下
      1 婚姻是两个异性的人之间根据本法典的规定	意在以完全共同生活的方式建立家庭而订立的合同	由此可见
      1 婚姻是一男一女以永续共同生活为目的的结	合	同时
      1 婚姻是一夫一妻的终身结合	神事和人事的共同关系	优帝
      1 婚姻家庭有着鲜明的伦理性和民族特色	与一个国家的历史	传统
      1 婚姻制度本身并不是一个完全	私人的东西	他与公共利益密切相关
      1 婚姻制度很可能随之瓦解	无论你是否愿意承认	婚姻制度本身并不是一个完全
      1 婚姻关系实质上是伦理关系	以前大多数自然法的著述	只是从肉体方面
      1 婚姻不单单只是关注性的关系和自然属性	还应该考虑其他因素	笔者认为
      1 婚姻	的话	婚姻制度很可能随之瓦解
      1 婚	这种状况依然存在	智行基金会在对2600多名同性恋者的问卷调查中显示
      1 娱乐先生深圳站介绍	萧敬腾2018巡回演唱会	安室奈美惠巡回告别演唱会深圳站介绍
      1 娱乐	母婴	美食
      1 娱乐	休闲深圳	鹏城活动
      1 娱乐	休闲	打折
      1 妇科病吃什么食物好	深圳驾驶证到期了怎么换证	深圳驾驶证换证方法
      1 妇科病吃什么食物好	11种食物帮女人搞定妇科病	妇科病吃什么食物好
      1 妇科用药	治疗妇科疾病的药物有	不孕不育吃什么药好
      1 妇科用药	治疗妇科疾病的药物	肠胃不好吃什么药
      1 妇科用药	不孕不育吃什么药好	治疗不孕不育的药物
      1 妇科	外科	男科
      1 妇人因夫而	成	故曰姻
      1 妇产儿科	男科	五官科
      1 妇之父母	婿之父母相谓为婚姻	由此可见
      1 妇之父为婚	妇之父母	婿之父母相谓为婚姻
      1 如果什么样的自愿结合都可以成为	婚姻	的话
      1 如懿传分集剧情介绍	29	30集
      1 如何选购水龙头	水龙头选购技巧	墙壁发霉怎么处理
      1 如何延长做爱时间	延长性爱时间的5个方法	男性保健品有哪些
      1 如何延长做爱时间	延长性爱时间的5个方法	如何延长做爱时间
      1 如何延长做爱时间	延长	男科药物功能主治介绍
      1 如两性的生理差别	性的本能	和种族的繁衍等
      1 好用的男士洗面奶推荐	男士洗面奶十大排行	热点排行
      1 女曰姻	尔雅释亲	则说
      1 女方离婚起诉书范本	新版离婚证样本图片	2018年全国各地婚假规定一览表
      1 女性健康饮食	男性健康饮食	儿童健康饮食
      1 女性	范文	主页
      1 女人佩戴什么可以转运	女人佩戴什么可以招财	女人佩戴什么可以转
      1 女人佩戴什么可以转	2018孕妇可以参加婚礼吗	2018离婚损害赔偿金额标准
      1 女人佩戴什么可以招财	女人佩戴什么可以转	2018孕妇可以参加婚礼吗
      1 夫妻离婚后户口怎么办	离婚后女方户口处	二胎产假国家规定
      1 外语培训	电脑培训	高等教育
      1 外科	男科	右下腹隐痛的原因是什么
      1 外科	内科	妇产儿科
      1 壮阳药排行榜10强	口碑最好的壮阳药	深圳
      1 墙壁发霉预防措施	2018年的财位在哪个方向	2018风水禁忌
      1 墙壁发霉怎么处理	墙壁发霉预防措施	2018年的财位在哪个方向
      1 培训	学车	旅游
      1 培训	学历教育	中小学教育
      1 地铁	电费	专题
      1 在社会承认下	约定以永久共处的方式来共同担负抚育子女的责任	传宗接代
      1 图说新闻	2018离婚补偿的条件	离婚补偿要满足的条件
      1 图行天下	我要	结婚
      1 图片	教育	婴幼
      1 图文详解说明	男士裤子尺码对照表	保暖内衣什么牌子好
      1 国内旅游	出境旅游	游记见闻
      1 因此	它	只被看成一种性的关系
      1 因此	中国的同性婚姻问题首先不能回避的是中国家庭传宗接代的基本功能	罗马法学家莫蒂迪斯蒂努斯指出
      1 因为同性恋者的权利不一定要通过法律来保护	但传统的婚姻伦理一旦被否	定
      1 因	为目前同性婚姻合法化在中国是行不通的	下面给大家讲一下同性婚姻合法化在中国行不通的四大原因吧
      1 回归到中国社会	从古至今中华民族都是在男女结合的婚姻制度下繁衍的	对于婚姻
      1 喜宴酒店	婚纱照	婚礼用品
      1 商户搜索	常用查询	生活指南
      1 哪里可以买到排卵试纸	排卵试纸怎么看	伤口化脓怎么处理
      1 哪些包子馅适合宝宝吃	这几款值得	冬瓜怎么做给宝宝吃好
      1 哪些人不适合拔牙	不宜拔牙的十类	拔牙有哪些危害
      1 哪些人不适合	臭梧桐根的功效与作用	精神病和神经病有什么区别
      1 哪些人不能吃姜	男人吃生姜的好处	哪
      1 哪	黄骨鱼怎么炖汤好喝	搭配紫苏超不错
      1 哈姓男孩取名	三字好听的名字	红姓男孩取名
      1 和种族的繁衍等	这是婚姻区别于其他社会关系的重要特征	回归到中国社会
      1 味道香甜回味无穷	红枣奶香玉米面发糕	南瓜怎么做面包好吃
      1 味道香	脆皮烤五花肉的做法	色泽美观回味
      1 周边旅游	港澳旅游	国内旅游
      1 周边	港澳	结婚
      1 后果难以设想	二	同性婚姻合法化破坏了中国家庭传宗接代的基本功能
      1 同时	很多国家的婚姻法都规定了合法婚姻是没有血缘关系的一男一女之间的结合	例如
      1 同性相吸	异性相斥	阴阳相调
      1 同性婚姻合法化破坏了男女结合的中国传统伦理	婚姻是文明社会里最基本的单位	是社会伦理的重要体现
      1 同性婚姻合法化破坏了中国家庭传宗接代的基本功能	黑格尔在	法哲学原理
      1 同性婚姻合法化在中国行不通的四大原因	作者	朱尖的
      1 同性婚姻合法化在中国行	同性婚姻合法化在中国行不通的四大原因	作者
      1 同性婚姻不能确保人类的传宗接代	虽然如今可以通过人工授精等高科技手段	实现生
      1 合二姓之好	上以事宗庙	而下以继后世也
      1 合	同时	很多国家的婚姻法都规定了合法婚姻是没有血缘关系的一男一女之间的结合
      1 各种避孕药的用法用量介绍	避孕药有哪些	各种避孕药的用法用
      1 各种避孕药的用法用	相关资讯	2018家暴离婚需要什么证据
      1 吃什么药可以补血	补血的药物有哪些	治疗妇科疾病的药物有哪些
      1 右下腹隐痛的原因是什么	腹部疼痛详细位置	薏苡仁和薏米有区别吗
      1 右下腹隐痛的原因是什么	腹部疼痛详细位置	右下腹隐痛的原因是什
      1 右下腹隐痛的原因是什么	腹部疼痛详细位置	右下腹隐痛的原因是
      1 右下腹隐痛的原因是什么	腹部	哪些人不适合拔牙
      1 右下腹隐痛的原因是什	感冒吃什么药	治疗感冒的药物有哪些
      1 右下腹隐痛的原因是	右下腹隐痛的原因是什么	腹部
      1 台式机	影像设备	数字家电
      1 只被看成一种性的关系	而通往婚姻其他道路一直都被阻塞	正如黑格尔所说
      1 只有25	0	的同性恋者表示一定不会结婚
      1 只是从肉体方面	从婚姻的自然属性方面来看待婚姻	因此
      1 口红王子中国版综艺嘉宾介绍	香蜜沉沉烬如霜分剧情介绍	61
      1 口碑最好的壮阳药	深圳	旅游
      1 发表评论	____________________________________________________________	____________________________________________________________
      1 发低烧怎么办	缓解低烧的办法	左下腹部隐痛的原因
      1 去日本北海道旅游的最佳时间	去日本北海道旅游的	2018深圳爬山去哪里比较好
      1 去日本北海道旅游的	2018深圳爬山去哪里比较好	2018深圳爬山去哪里比
      1 厨房灶台风水禁忌	灶台朝向风水	搬家有什么讲究
      1 历尽千古而文	明不断的重要因素	中国人长期认可的婚姻关系是指男女通过结婚所形成的夫妻关系
      1 卫生间除臭技巧	卫生间异味如何去除	泰式装修风格特点有哪些
      1 卫生间异味如何去除	泰式装修风格特点有哪些	泰式装修设计要点
      1 卫生间异味如何去除	卫生间除臭技巧	卫生间异味如何去除
      1 卧室窗户材质类型	卧室窗户怎么设计	卧
      1 卧室窗户怎么设计	卧室窗户材质类型	卧室窗户怎么设计
      1 卧室窗户怎么设计	卧	美缝剂什么牌子好
      1 卧	美缝剂什么牌子好	美缝剂如何
      1 南瓜怎么做面包好吃	加入鸡蛋	红枣奶香玉米面发糕的做法
      1 单方起诉离婚的程序步骤介绍	热门关注	婚庆
      1 十大男性保健品排行榜	男人气虚的症状有哪些	男人气虚怎么补才好
      1 十大功劳的功效与作用	十大功劳叶	蟛蜞菊的功效与作用
      1 十大功劳叶	蟛蜞菊的功效与作用	蟛蜞菊的药用
      1 十万落地的家用车推荐	十万落地的家用车哪	20万mpv车型哪款好
      1 十万落地的家用车哪款好	十万落地的家用车推荐	十万落地的家用车哪
      1 十万落地的家用车哪	20万mpv车型哪款好	20万左右的
      1 医疗健康	资讯	内科
      1 医疗	急诊	中药
      1 医疗	健康	资讯
      1 北京办理准生证流程	2018北京如何办理准生证	2018离婚补偿的条件
      1 加点生姜会更	蒜香芹菜叶的做法	淋上香油会更入
      1 加点姜会更入味	鸭肠怎么炒最好吃	加
      1 加点姜会更	鱿鱼和什么一起炒好吃	搭配西葫芦
      1 加点冰糖会	山药红豆糕的做法	人见人爱的美味
      1 加入鸡蛋	红枣奶香玉米面发糕的做法	味道香
      1 加	鸭肠怎么炒最好吃	加点姜会更
      1 办公设备	网络设备	深圳IT
      1 办事	户籍	婚育
      1 刹车灯不亮是什么原因	汽车刹车灯不亮解	2018科目三考试合格标准介绍
      1 到期换驾	驾驶证换证在哪里办	驾驶证到期
      1 别姓男孩取名	二字好听的名字精选	祖姓男孩取名
      1 别姓女孩取名	这些名字超唯美	芹菜怎么做给宝宝吃
      1 利姓女孩取名	三字好听的名字推荐	利姓女孩取名
      1 利姓女孩取名	三字好	别姓女孩取名
      1 则说	婿之父为姻	妇之父为婚
      1 刘强东性侵案新进展	蒋聘婷否认刘强东性侵案女	刘强东性侵案新进展
      1 刘强东性侵案新进展	蒋聘婷否认刘	巨齿鲨主题曲是什么
      1 刘强东性侵案新进展	巨齿鲨主题曲是什么	爱拯救世界歌词介绍
      1 刘强东已经回国	刘强东回国第一时间做了什么	刘强东已经回国
      1 刘强东已经回国	刘强	利姓女孩取名
      1 刘强东回国第一时间做了什么	刘强东已经回国	刘强
      1 刘强	利姓女孩取名	三字好听的名字推荐
      1 分娩期	产后护理	母婴用品
      1 分享到	QQ空间	微信
      1 出境旅游	游记见闻	图行天下
      1 几千年以来	人类文化都是将婚姻视为男女间的结合	其目的在于抚养孩子
      1 准备怀孕	怀孕期	分娩期
      1 冬瓜怎么做给宝宝吃好	这些吃法超	豌豆怎么做给宝宝吃好
      1 再创世纪男主郭晋安个人资料介绍	再创世纪男主郭晋安个人资料介绍	再创世纪男主郭晋安
      1 再创世纪男主郭晋安个人资料介绍	再创世纪男主郭晋安	如懿传分集剧情介绍
      1 再创世纪男主郭晋安	如懿传分集剧情介绍	29
      1 内科	妇科	外科
      1 内科	妇产儿科	男科
      1 养鱼风水禁忌	婴儿床怎么选购	婴儿床使用方法
      1 其目的在于抚养孩子	家庭的基本功能是繁衍后代	礼记昏义
      1 关于我们	网站地图	法律声明
      1 共2页	上一页	1
      1 八万以内最省油的车有哪些	节气门清洗一次多少钱	节气门一般多久清
      1 全国姓氏人口数量排名	中国哪个姓	2018世界各国人口密度排名
      1 儿童房装修注	榻榻米什么品牌好	榻榻米选购注意
      1 儿童房怎么装修好看	儿童房装修注	榻榻米什么品牌好
      1 儿童健康饮食	老人健康饮食	饮食资讯
      1 健康	资讯	深圳医疗
      1 健康	医疗	急诊
      1 健康	准备怀孕	怀孕期
      1 健康	2018广西桂林旅游攻略	桂林旅游行程如何安排
      1 保暖内衣什么牌子好	男士洗面奶十大排行	好用的男士洗面奶推荐
      1 保暖内衣什么牌子好	2018保暖内衣品牌推荐	保暖内衣什么牌子好
      1 侵权投诉	娱乐	休闲
      1 例如	美国众议院于1996年7月通过的	捍卫婚姻法
      1 你看起来好像很好吃童话剧演出深圳站介绍	你看起来好像很好吃童	萧敬腾2018巡回演唱会
      1 你看起来好像很好吃童话剧演出深圳站介绍	你看起来好像很好吃	刘强东性侵案新进展
      1 你看起来好像很好吃童话剧演出深	刘强东性侵案新进展	蒋聘婷否认刘
      1 你看起来好像很好吃童	萧敬腾2018巡回演唱会	娱乐先生深圳站介绍
      1 你看起来好像很好吃	刘强东性侵案新进展	蒋聘婷否认刘强东性侵案女
      1 作者	朱尖的	2015
      1 体育	留学	移民
      1 但过于依赖物质化	无法体现生育的人文价值	从现实意义上讲
      1 但在广大农村	中小城市	甚至在大城市传统婚姻传宗接代
      1 但同时也在质疑	中国同性婚姻合法化到底还需要多久	答案可能要让很多人失望了
      1 但传统的婚姻伦理一旦被否	定	会破坏男女相配
      1 伤口化脓怎么处理	介绍几种正确的处理方法	发低烧怎么办
      1 伤口化脓怎么处理	介绍几种正确的处理方法	伤口化脓怎么处理
      1 伤口化脓怎么处理	介绍	解析阑尾炎的位置在身体的哪个部位
      1 传统	文化	与一个民族的思维方式
      1 传染科	急诊	西药大全
      1 传宗接代	是中国家庭的重要功能	有学者在农村调查中发现能够接受子女为同性恋的仅为8
      1 会破坏男女相配	繁衍种族的自然法则	抹杀了传统观念中阴阳两性之间质的差别
      1 优缺点是什	真皮沙发什么品牌好	真皮沙发选购
      1 优惠打折	生活时尚	电影大片
      1 优帝	法学纲要	称
      1 休闲深圳	鹏城活动	演出资讯
      1 休闲深圳	演出	户外
      1 休闲	打折	演出
      1 休闲	娱乐	休闲深圳
      1 价值取向	审美趣味等都密切相关	因此
      1 价位在15万左右的车哪款好	4款15万左右车	2018开车哪些行为扣6分
      1 以前大多数自然法的著述	只是从肉体方面	从婚姻的自然属性方面来看待婚姻
      1 代位继承与转继承的区别	相关阅读	2018年婚姻法离婚最新规定2018
      1 他与公共利益密切相关	法律当然需要保护弱势群体的利	益
      1 从现实意义上讲	很难获得中华民族的认可	虽然
      1 从根本上影响中国传统家庭的和谐	互补与满足	后果难以设想
      1 从婚姻的自然属性方面来看待婚姻	因此	它
      1 从婚姻伦理是从人类的自然属性出发的	是男女两性的自然生理的结合	一个的合法婚姻首先应该肯定婚姻的自然属性
      1 从古至今中华民族都是在男女结合的婚姻制度下繁衍的	对于婚姻	白虎通
      1 从利益衡量的角度来说	肯定是婚姻伦理更为重要	因为同性恋者的权利不一定要通过法律来保护
      1 介绍几种正确的处理方法	发低烧怎么办	缓解低烧的办法
      1 介绍几种正确的处理方法	伤口化脓怎么处理	介绍
      1 介绍	解析阑尾炎的位置在身体的哪个部位	解析阑尾炎的位置在身
      1 什么户型的房子不能买	买房风水注意事项	2018十大洗衣机品牌排行榜
      1 人见人爱的美味	男人吃生姜的好处	哪些人不能吃姜
      1 人见人爱的下饭	排骨怎么做好吃又简单	加点冰糖会
      1 人类文化都是将婚姻视为男女间的结合	其目的在于抚养孩子	家庭的基本功能是繁衍后代
      1 人的心率正常范围是多少	标准心率值是多少	人的心率正常范围是多
      1 人的心率正常范围是多	神经性头痛吃什么药	神经科药物有哪些
      1 人体左腹部是什么器官	男科药物功能主治介绍	男科用药大全
      1 人人网	豆瓣网	QQ好友
      1 产后护理	母婴用品	新生儿
      1 交通	查询	社保
      1 井柏然回怼粉丝diss工作室	照片差不	口红王子中国版综艺嘉宾介绍
      1 五指毛桃的禁忌人群	哪些人不适合	臭梧桐根的功效与作用
      1 五折特惠	深圳野生动物园终于降价了	五折特惠
      1 五折特惠	深圳野生动物	深圳世界之窗69
      1 五官科	皮肤性病	精神心理
      1 五大法学家之一的	莫德斯体努斯对婚姻所下的定义称	婚姻是一夫一妻的终身结合
      1 互补与满足	后果难以设想	二
      1 二胎产假有多少天	新婚姻法关于房产的规定	2018最新规定
      1 二胎产假国家规定	二胎产假有多少天	新婚姻法关于房产的规定
      1 二字好听的名字精选	祖姓男孩取名	这些名字真心不错
      1 二	同性婚姻合法化破坏了中国家庭传宗接代的基本功能	黑格尔在
      1 买房风水注意事项	2018十大洗衣机品牌排行榜	瓷砖旧了怎么办
      1 乃一夫一妻之终身结合	目的在于生男育女	继血统
      1 主题曲	你看起来好像很好吃童话剧演出深圳站介绍	你看起来好像很好吃
      1 主页	深圳结婚	婚姻法
      1 为目前同性婚姻合法化在中国是行不通的	下面给大家讲一下同性婚姻合法化在中国行不通的四大原因吧	一
      1 中说	婚姻者	合二姓之好
      1 中药大全	政策考试	数码
      1 中药	办事	户籍
      1 中指出	婚姻关系实质上是伦理关系	以前大多数自然法的著述
      1 中小学教育	婴幼儿教育	职业培训
      1 中小学什么时候	2018年雅加达亚运会40个比赛项目及赛程时	2018秋季初中开学典礼学生主持词
      1 中小城市	甚至在大城市传统婚姻传宗接代	生儿育女的观念仍然相当浓烈
      1 中国距离同性婚姻合法化还有多远	下一篇	代位继承与转继承的区别
      1 中国的婚姻观念和家庭伦理与同	性恋者的权利保护到底孰轻孰重	从利益衡量的角度来说
      1 中国的同性恋者和西方的最大区别就是大多数人会选择与异性结	婚	这种状况依然存在
      1 中国的同性婚姻问题首先不能回避的是中国家庭传宗接代的基本功能	罗马法学家莫蒂迪斯蒂努斯指出	婚姻者
      1 中国现存的复姓有哪些	中国复姓大	全国姓氏人口数量排名
      1 中国对于婚姻伦理的重视是中华民族得以世世代代繁衍不息	历尽千古而文	明不断的重要因素
      1 中国复姓大	全国姓氏人口数量排名	中国哪个姓
      1 中国哪个姓	2018世界各国人口密度排名	张三丰的神话故事
      1 中国同性婚姻合法化诉求的出现	并不表明中国传统婚姻观念已经发生巨大的变革	法律尤其是婚姻家庭法是一国传统伦理道德和传统文化沉积的产物
      1 中国同性婚姻合法化到底还需要多久	答案可能要让很多人失望了	因
      1 中国人长期认可的婚姻关系是指男女通过结婚所形成的夫妻关系	是两性关系的结合	是中华民族对性的完美表达
      1 中国34省市面积排名	殿堂级诗人阿多尼斯专题讲座免费领票	殿堂级诗人阿多尼斯
      1 中国34省市面积排名	最大166万平方公里	中国34省市面积排名
      1 东汉和三国之间的区别	东汉和三国之间的区	2018教师节作文600字范文五篇
      1 东汉和三国之间的区	2018教师节作文600字范文五篇	2018教师节作文600字范
      1 世界各国不管信仰如何	长期以来人们都遵循着一男一女互相结合的婚姻定义	五大法学家之一的
      1 世界上女多男少的国家有哪些	2018中国男女比例是多少	男女比例失
      1 专题	星座	解梦
      1 与一个民族的思维方式	价值取向	审美趣味等都密切相关
      1 与一个国家的历史	传统	文化
      1 不宜拔牙的十类	拔牙有哪些危害	拔牙的并发症介绍
      1 不孕不育吃什么药好	治疗乳腺疾病的药物有哪些	治疗妇科疾病的药物有哪些
      1 不孕不育吃什么药好	治疗不孕不育的药物	孕妇能吃月饼吗
      1 不孕不育吃什么药好	治疗不孕不育的药物	不孕不育吃什么药好
      1 下面给大家讲一下同性婚姻合法化在中国行不通的四大原因吧	一	同性婚姻合法化破坏了男女结合的中国传统伦理
      1 下一页	gongzhonghao	jpg
      1 下一篇	代位继承与转继承的区别	相关阅读
      1 上规定的	婚姻概念是	一个男人和一个女人的结合
      1 上以事宗庙	而下以继后世也	我国著名社会学家费孝通在论及婚姻的本质时就曾经
      1 上一页	1	2
      1 上一篇	中国距离同性婚姻合法化还有多远	下一篇
      1 三字好听的名字推荐	利姓女孩取名	三字好
      1 三字好听的名字	红姓男孩取名	高分好听的名字推荐
      1 三字好	别姓女孩取名	这些名字超唯美
      1 七八万小型suv哪款好	家用七八万小型su	刹车灯不亮是什么原因
      1 一个的合法婚姻首先应该肯定婚姻的自然属性	如两性的生理差别	性的本能
      1 一个男人和一个女人的结合	而	葡萄牙民法典
      1 一	同性婚姻合法化破坏了男女结合的中国传统伦理	婚姻是文明社会里最基本的单位
      1 www	chachaba	com
      1 wc	btn	png
      1 VEX机器人2018	2019赛季亚洲公开赛即将启动	VEX机器人2018
      1 VEX机器人2018	2019赛季	春茧儿童剧场
      1 QQ空间	微信	百度贴吧
      1 QQ好友	上一篇	中国距离同性婚姻合法化还有多远
      1 png		
      1 MBA	文艺	体育
      1 J中国巡演	深圳站	殿堂级诗人阿多尼斯专题讲座免费领票
      1 J中国巡演	深圳站	Jessie
      1 jpg	分享到	QQ空间
      1 gongzhonghao	jpg	分享到
      1 com	近日	美国同性婚姻合法化让很多中国的男同女同们看到了希望
      1 com	本地生活	首选品牌
      1 chachaba	com	近日
      1 chachaba	com	本地生活
      1 btn	png	
      1 9月份有什么节日	2018初中开学典礼校长发言稿	2018雅加达亚运会所有比赛项目
      1 9元通玩	带宝贝周游世界吧	深圳世界之窗69
      1 9元通玩	69	9元玩遍广东
      1 9元玩遍广东	50多个热门景区任性玩	69
      1 9元玩遍广东	50多个热	潮派牛肉火锅5折特惠速抢攻略介绍
      1 89	这样的数字与欧美国家动辄过半的同性恋支持率相差甚远	早在2002年
      1 69	9元玩遍广东	50多个热门景区任性玩
      1 69	9元玩遍广东	50多个热
      1 63集	再创世纪男主郭晋安个人资料介绍	再创世纪男主郭晋安个人资料介绍
      1 61	63集	再创世纪男主郭晋安个人资料介绍
      1 5万左右省油的车哪款好	4款5万左右省油的	八万以内最省油的车有哪些
      1 57	3	的同性恋者已经或将要接受异性婚姻
      1 55分身材的赵丽颖	完美穿衣超显腿长	55分身材的赵丽颖
      1 55分身材的赵丽颖	完美	男士裤子尺码对照表
      1 55	2018新婚姻法子女抚养费相关规定介绍2018	08
      1 50多个热门景区任性玩	69	9元玩遍广东
      1 50多个热	潮派牛肉火锅5折特惠速抢攻略介绍	潮派牛肉火锅5折特惠速
      1 4款5万左右省油的	八万以内最省油的车有哪些	节气门清洗一次多少钱
      1 4款15万左右车	2018开车哪些行为扣6分	开车扣6分的违法行
      1 47	30	新婚姻法2018关于房产
      1 46	55	2018新婚姻法子女抚养费相关规定介绍2018
      1 44030302000083号	wc	btn
      1 43	20	2018新婚姻法婚外情相关规定2018
      1 39	发表评论	____________________________________________________________
      1 30集	你看起来好像很好吃童话剧演出深	刘强东性侵案新进展
      1 30	新婚姻法2018关于房产	新婚姻法关于房产的规定2018
      1 3	的同性恋者已经或将要接受异性婚姻	只有25
      1 29	30集	你看起来好像很好吃童话剧演出深
      1 24	2018年婚姻律师费一般多少钱	打离婚官司多少钱2018
      1 23	10	47
      1 23	10	46
      1 22	查查吧	www
      1 20万左右的	深圳科目三考场有哪些	深圳科目
      1 20万mpv车型哪款好	20万左右的	深圳科目三考场有哪些
      1 2019赛季亚洲公开赛即将启动	VEX机器人2018	2019赛季
      1 2019赛季	春茧儿童剧场	来自星星的塞勒公益演出介绍
      1 2019年1月6日适合结婚	2018年11月结婚好日子	2018年11月适合结婚的
      1 2019年1月6日结婚好吗	2019年1月6日适合结婚	2018年11月结婚好日子
      1 2019年1月29日结婚好吗	1月29日适合结	女人佩戴什么可以转运
      1 2019年1月28日结婚好吗	1月28日适合结	2019年1月29日结婚好吗
      1 2019年1月27日结婚好吗	1月27日适合结	2019年1月28日结婚好吗
      1 2019年1月1日适合结婚	2018年12月22日结婚好不好	12月22日适合结婚
      1 2019年1月1日结婚好吗	2019年1月1日适合结婚	2018年12月22日结婚好不好
      1 2018鹰潭8月份好玩的地方大全	2018年宿迁8月份好玩的地方大全	2018广东国庆自驾旅游推荐
      1 2018香港10月份好玩的地方大全	2018台湾9月份好玩的地方大全	2018达州9月份好玩的地方大全
      1 2018风水禁忌	实木地板清洁技巧	实木地板如何保养
      1 2018雅加达亚运会所有项目金牌总数	2018秋季开学典礼校长发言致辞四篇	2018小学开学典礼校长发言稿
      1 2018雅加达亚运会所有比赛项目	2018秋季中小学开学时间	中小学什么时候
      1 2018陕西5a景区有哪些	陕西5a景区排名	2018陕西5a景区有哪些
      1 2018陕西5a景区有哪些	去日本北海道旅游的最佳时间	去日本北海道旅游的
      1 2018长沙8月份好玩的地方大全	医疗健康	资讯
      1 2018铜川9月份好玩的地方大全	深圳暑假怎么玩	这些地方没去过就不算到过深圳
      1 2018遵义9月份好玩的地方大全	2018铜川9月份好玩的地方大全	深圳暑假怎么玩
      1 2018遂宁9月份好玩的地方大全	2018内江9月份好玩的地方大全	2018乐山9月份好玩的地方大全
      1 2018达州9月份好玩的地方大全	2018遵义9月份好玩的地方大全	2018铜川9月份好玩的地方大全
      1 2018车载歌曲哪些好听	2018好听的车载歌曲	价位在15万左右的车哪款好
      1 2018起诉离婚程序	起诉离婚流程	休闲深圳
      1 2018诉讼离婚需要什么条件	诉讼离婚的法定条件	2018诉讼离婚需要什
      1 2018诉讼离婚需要什么条件	诉讼离婚的法	2018起诉离婚程序
      1 2018诉讼离婚需要什	旅游	结婚
      1 2018结婚新郎保证书搞笑版范文	2018结婚新郎保证书搞	卧室窗户怎么设计
      1 2018结婚新郎保证书搞	卧室窗户怎么设计	卧室窗户材质类型
      1 2018科目三考试合格标准介绍	2018年淮安有什么好玩的地方	2018临沂8月份好玩的地方大全
      1 2018秋季开学典礼校长发言致辞四篇	2018小学开学典礼校长发言稿	2018年雅加达亚运会参赛国家和地区有哪些
      1 2018秋季初中开学典礼学生主持词	10万元紧凑型车推荐	10万元左右紧凑型车
      1 2018秋季中小学开学时间	中小学什么时候	2018年雅加达亚运会40个比赛项目及赛程时
      1 2018离婚补偿的条件	离婚补偿要满足的条件	2018离婚补偿的条件
      1 2018离婚补偿的条件	离婚补偿要满足的条	2018孕妇离婚有些什么补偿
      1 2018离婚补偿的条件	离婚补偿要满足	2018孕妇离婚有些什么补偿
      1 2018离婚补偿的条件	2018孕妇离婚有些什么补偿	2018孕妇离婚有些什
      1 2018离婚损害赔偿金额标准	2018离婚补偿的条件	离婚补偿要满足
      1 2018福布斯亚洲富豪排行榜	2018世界各国人口密度排名	2018世界各国人口密度
      1 2018深圳赏花攻略	深圳周边赏花的地方	2018陕西5a景区有哪些
      1 2018深圳爬山去哪里比较好	2018深圳爬山去哪里比	2018一般的婚礼蛋糕多少钱
      1 2018深圳爬山去哪里比	2018一般的婚礼蛋糕多少钱	2018一般的婚礼蛋糕多
      1 2018有刘海的新娘发型图片	2019年1月27日结婚好吗	1月27日适合结
      1 2018最新规定	新婚姻法18岁结婚	结婚年龄至少20岁解析
      1 2018曲靖9月份好玩的地方大全	2018广元9月份好玩的地方大全	2018遂宁9月份好玩的地方大全
      1 2018新郎唱给新娘的歌曲推荐	2018新郎唱给新娘的歌	婚礼当天新娘注意事项
      1 2018新郎唱给新娘的歌	婚礼当天新娘注意事项	要美丽一整天
      1 2018新婚姻法子女抚养费相关规定介绍2018	08	23
      1 2018新婚姻法婚外情相关规定2018	08	23
      1 2018教师节贺卡祝福语大全	赞美老师的话语	2018教师节贺卡祝福语
      1 2018教师节贺卡祝福语	中国34省市面积排名	最大166万平方公里
      1 2018教师节作文600字范文五篇	2018教师节作文600字范	2018教师节贺卡祝福语大全
      1 2018教师节作文600字范	2018教师节贺卡祝福语大全	赞美老师的话语
      1 2018抖音好听的韩文歌	适合在婚礼放的韩	如何选购水龙头
      1 2018张家界8月份好玩的地方大全	2018年绵阳8月份好玩的地方大全	2018年东莞8月份好玩的地方大全
      1 2018开车哪些行为扣6分	开车扣6分的违法行	七八万小型suv哪款好
      1 2018广西桂林旅游攻略	桂林旅游行程如何安排	2018广西桂林旅游攻略
      1 2018广西桂林旅游攻略	2018香港10月份好玩的地方大全	2018台湾9月份好玩的地方大全
      1 2018广元9月份好玩的地方大全	2018遂宁9月份好玩的地方大全	2018内江9月份好玩的地方大全
      1 2018广东国庆自驾旅游推荐	广东国庆哪里	2018年松原8月份好玩的地方大全
      1 2018年雅加达亚运会参赛国家和地区有哪些	2018年9月份节日	9月份有什么节日
      1 2018年雅加达亚运会40个比赛项目及赛程时	2018秋季初中开学典礼学生主持词	10万元紧凑型车推荐
      1 2018年绵阳8月份好玩的地方大全	2018年东莞8月份好玩的地方大全	2018长沙8月份好玩的地方大全
      1 2018年离婚买房新政策	离婚买房相关法律	2018年12月23日结婚好不好
      1 2018年的财位在哪个方向	2018风水禁忌	实木地板清洁技巧
      1 2018年淮安有什么好玩的地方	2018临沂8月份好玩的地方大全	2018鹰潭8月份好玩的地方大全
      1 2018年松原8月份好玩的地方大全	2018张家界8月份好玩的地方大全	2018年绵阳8月份好玩的地方大全
      1 2018年宿迁8月份好玩的地方大全	2018广东国庆自驾旅游推荐	广东国庆哪里
      1 2018年婚姻法离婚最新规定2018	09	06
      1 2018年婚姻法离婚最新规定	2018诉讼离婚需要什么条件	诉讼离婚的法
      1 2018年婚姻法离婚最新规定	2018新郎唱给新娘的歌曲推荐	2018新郎唱给新娘的歌
      1 2018年婚姻法离婚最新规定	2018年婚姻法离婚最	2018诉讼离婚需要什么条件
      1 2018年婚姻法离婚最	2018诉讼离婚需要什么条件	诉讼离婚的法定条件
      1 2018年婚姻律师费一般多少钱	打离婚官司多少钱2018	05
      1 2018年全国各地婚假规定一览表	夫妻离婚后户口怎么办	离婚后女方户口处
      1 2018年东莞8月份好玩的地方大全	2018长沙8月份好玩的地方大全	医疗健康
      1 2018年9月份节日	9月份有什么节日	2018初中开学典礼校长发言稿
      1 2018年12月23日结婚好不好	12月23日适合结婚	2018年12月1日结婚好不好
      1 2018年12月22日结婚好不好	12月22日适合结婚	2018抖音好听的韩文歌
      1 2018年12月1日结婚好不好	12月1日适合结婚	2019年1月6日结婚好吗
      1 2018年12月16日结婚好不好	12月16日适合结婚	2018好听的日文歌曲推荐
      1 2018年11月适合结婚的	2018年12月16日结婚好不好	12月16日适合结婚
      1 2018年11月结婚好日子	2018年11月适合结婚的	2018年12月16日结婚好不好
      1 2018小学开学典礼校长发言稿	2018年雅加达亚运会参赛国家和地区有哪些	2018年9月份节日
      1 2018家暴离婚需要什么证据	2018家暴离婚需要什么证	2018北京如何办理准生证
      1 2018家暴离婚需要什么证	2018北京如何办理准生证	北京办理准生证流程
      1 2018孕妇离婚有些什么补偿	2018年婚姻法离婚最新规定	2018诉讼离婚需要什么条件
      1 2018孕妇离婚有些什么补偿	2018年婚姻法离婚最新规定	2018新郎唱给新娘的歌曲推荐
      1 2018孕妇离婚有些什么补偿	2018孕妇离婚有些什	2018年婚姻法离婚最新规定
      1 2018孕妇离婚有些什	2018年婚姻法离婚最新规定	2018年婚姻法离婚最
      1 2018孕妇可以参加婚礼吗	2018离婚损害赔偿金额标准	2018离婚补偿的条件
      1 2018好听的车载歌曲	价位在15万左右的车哪款好	4款15万左右车
      1 2018好听的日文歌曲推荐	2019年1月1日结婚好吗	2019年1月1日适合结婚
      1 2018台湾9月份好玩的地方大全	2018达州9月份好玩的地方大全	2018遵义9月份好玩的地方大全
      1 2018十大洗衣机品牌排行榜	瓷砖旧了怎么办	瓷砖怎么翻新
      1 2018北京如何办理准生证	北京办理准生证流程	2018北京如何办理准生证
      1 2018北京如何办理准生证	2018离婚补偿的条件	离婚补偿要满足的条
      1 2018初中开学典礼校长发言稿	2018雅加达亚运会所有比赛项目	2018秋季中小学开学时间
      1 2018内江9月份好玩的地方大全	2018乐山9月份好玩的地方大全	深圳周边赏花的地方
      1 2018全国各省市人口密度排名	中国现存的复姓有哪些	中国复姓大
      1 2018保暖内衣品牌推荐	保暖内衣什么牌子好	男士洗面奶十大排行
      1 2018乐山9月份好玩的地方大全	深圳周边赏花的地方	2018深圳赏花攻略
      1 2018临沂8月份好玩的地方大全	2018鹰潭8月份好玩的地方大全	2018年宿迁8月份好玩的地方大全
      1 2018中国男女比例是多少	男女比例失	迪拜十大富豪排行榜
      1 2018世界各国人口密度排名	张三丰的神话故事	张三丰是谁
      1 2018世界各国人口密度排名	2018世界各国人口密度	2018全国各省市人口密度排名
      1 2018世界各国人口密度	2018全国各省市人口密度排名	中国现存的复姓有哪些
      1 2018一般的婚礼蛋糕多少钱	2018一般的婚礼蛋糕多	新娘美甲图片2018款式
      1 2018一般的婚礼蛋糕多	新娘美甲图片2018款式	2018有刘海的新娘发型图片
      1 2015	07	02
      1 20	2018新婚姻法婚外情相关规定2018	08
      1 2	下一页	gongzhonghao
      1 1月29日适合结	女人佩戴什么可以转运	女人佩戴什么可以招财
      1 1月28日适合结	2019年1月29日结婚好吗	1月29日适合结
      1 1月27日适合结	2019年1月28日结婚好吗	1月28日适合结
      1 18	01	39
      1 18	01	24
      1 12月23日适合结婚	2018年12月1日结婚好不好	12月1日适合结婚
      1 12月22日适合结婚	2018抖音好听的韩文歌	适合在婚礼放的韩
      1 12月1日适合结婚	2019年1月6日结婚好吗	2019年1月6日适合结婚
      1 12月16日适合结婚	2018好听的日文歌曲推荐	2019年1月1日结婚好吗
      1 11种食物帮女人搞定妇科病	妇科病吃什么食物好	深圳驾驶证到期了怎么换证
      1 11	43	20
      1 10万元紧凑型车推荐	10万元左右紧凑型车	5万左右省油的车哪款好
      1 10万元左右紧凑型车	5万左右省油的车哪款好	4款5万左右省油的
      1 10	47	30
      1 10	46	55
      1 10	22	查查吧
      1 1	而不能接受的占到91	89
      1 1	粤公网安备	44030302000083号
      1 1	2	下一页
      1 09	06	11
      1 07	02	10
      1 06	11	43
      1 02	10	22
      1 01	39	发表评论
      1 01	24	2018年婚姻律师费一般多少钱
      1 0	的同性恋者表示一定不会结婚	这也说明了在计划生育的今天
      1 ____________________________________________________________	评论	图说新闻
      1 ____________________________________________________________	____________________________________________________________	评论
