     54 删除	删除
     27 回应	删除
     19 2017	05
     12 来自豆瓣App	回应
     12 05	25
      8 2017	06
      5 06	04
      4 04	12
      3 诱导他们发展对同性的性欲	称作
      3 让一个内心就是带有歧视	视同性恋为异类的人来假装分析
      3 视同性恋为异类的人来假装分析	挺可笑的
      3 称作	不良的鼓励作用
      3 称为消极影响	诱导他们发展对同性的性欲
      3 挺可笑的	内心的自大淋漓尽致
      3 把同妻的问题抛给同性恋有什么不公平可言	虽然有外界不接纳等因素的关系
      3 把	从1
      3 到30	称为消极影响
      3 其实人都愿意看到自己想看到的东西	觉得你和几年前相比已经立场柔和了很多
      3 从1	到30
      3 25	19
      3 25	18
      3 25	17
      3 06	05
      3 05	26
      2 那对于她们又有什么公平呢	别把什么都归咎在外因上了
      2 那对于同妻来说呢	她的人
      2 诱导人们发展对异性的性欲	称为
      2 试问异性恋又	有多少能承担这样压力呢
      2 觉得你和几年前相比已经立场柔和了很多	但是有很多东西并不是靠想象和推演能够知道的
      2 虽然有外界不接纳等因素的关系	但是还是同性恋本身进入了这段婚姻
      2 虽然同妻现象不可原谅	但是
      2 获得一个成为普通人的权利	然而你们又在不断给更多的人一个解释心底不认同的借口
      2 而目前最大的问题就是	同性群体必须去争取每一个认同
      2 而	不是一味的希望外因自己改变来接纳同性恋
      2 称为	不良
      2 生就是被同性恋欺骗而毁掉的	那对于她们又有什么公平呢
      2 王路	王路
      2 然而你们又在不断给更多的人一个解释心底不认同的借口	这一点很可怕
      2 然后一点点去改变外因	而
      2 比如您也应该不	会把
      2 本身就是一件挺不公平的事情	试问异性恋又
      2 有多少能承担这样压力呢	为什么有一个群体必须去承担这种这种压力呢
      2 是自己的选择	那对于同妻来说呢
      2 把社会带来的羞耻和不认同带来的恶果指责在同志群体本身之上	又用此来带来更多社会对其更多不理解和不认同
      2 才能在足够的社会认同之后	获得一个成为普通人的权利
      2 并不是异性恋者在歧视	迫害同性恋
      2 带有负面态度的表达	比如您也应该不
      2 小飞	天灵灵
      2 小飞	2017
      2 婚姻的意义是什么	有人说
      2 她的人	生就是被同性恋欺骗而毁掉的
      2 天灵灵	地灵灵
      2 外因关系是有	但是需要那群人正视自己
      2 地灵灵	Felix
      2 同性群体必须去争取每一个认同	才能在足够的社会认同之后
      2 同性	带有负面态度的表达
      2 又用此来带来更多社会对其更多不理解和不认同	本身就是一件挺不公平的事情
      2 别把什么都归咎在外因上了	外因关系是有
      2 删除	小飞
      2 但是需要那群人正视自己	然后一点点去改变外因
      2 但是还是同性恋本身进入了这段婚姻	是自己的选择
      2 但是有很多东西并不是靠想象和推演能够知道的	虽然同妻现象不可原谅
      2 但是	把社会带来的羞耻和不认同带来的恶果指责在同志群体本身之上
      2 似乎还是一种对	同性
      2 会把	诱导人们发展对异性的性欲
      2 为什么有一个群体必须去承担这种这种压力呢	而目前最大的问题就是
      2 不良的鼓励作用	似乎还是一种对
      2 不良	吧
      2 不是一味的希望外因自己改变来接纳同性恋	而自己却选择逃避
      2 Felix	Felicis
      2 douban	com
      2 25	20
      2 22	47
      2 11	47
      2 05	28
      2 05	27
      1 鼓励异性恋者选择同性恋	对性向有什么误解吗
      1 鼓励异性恋者选择同性取向	要认识到这一点
      1 首页	浏览发现
      1 首先要了解	婚姻的意义是什么
      1 首先得承认一个前提	我们说的同性恋和异性恋
      1 音乐	同城
      1 靠谱一点	有人谈恋爱谈了七八年
      1 非但迫害自己	还迫害他人
      1 静静	静待花开
      1 静静	2018
      1 静待花开	不是同性恋
      1 需要一个自	我认同的过程
      1 雾里看花	能看出来你是女性
      1 雾里看花	努力和享受当下
      1 雾里看花	2017
      1 集邮	要集齐十二星座
      1 难道不应该支持	等到同婚
      1 难	拂
      1 隐藏性取向是可以理解的	但是
      1 随意繁殖	家庭建立不起来
      1 除毒品带来的犯罪问题	不是动员整个社会力量去铲除毒品
      1 阎浮众生刚强难化	9人喜欢
      1 阅读	FM
      1 间存在着巨大的差异	自己是这样
      1 问题是现在	同性恋是被压抑的
      1 长期和同性相处	同性恋的倾向
      1 都是好的	积极的
      1 都成问题	这才是婚姻的意义
      1 都叫我小瑞瑞	我口吃
      1 都叫我小瑞瑞	内心的自大淋漓尽致
      1 都叫我小瑞瑞	2017
      1 都会给自己和周围人带来痛苦	不单是同性恋
      1 都不是百分之百的	比如
      1 那只能期待某天你能理解了	来自豆瓣App
      1 那	婚姻的意义是什么
      1 那	婚姻的意义到底是什么呢
      1 遛狗时	一只公狗朝一只不认识的母狗扑上去
      1 造成冲突	产生更大的失序
      1 通常是不喜欢婚姻的	正因为有婚姻
      1 迫害同性恋	这反对者当中
      1 迫害同性恋	而是同性恋者自身对同性恋的歧视
      1 迫害同性恋	而是
      1 这需要时间	今天的很多同性恋者
      1 这都可以理解	产生同妻问题的同志是不可原谅的
      1 这话说得不对	这种痛苦
      1 这要因时	因地
      1 这种误解	歧视
      1 这种行为给自己	和别人带来的痛苦
      1 这种痛苦	更重要的是来自同性恋者自身对同性恋的歧视
      1 这种培养	不一定是主动的
      1 这次	台湾推动同性婚姻合法化
      1 这条路	比较简单
      1 这条路	会比较艰难
      1 这机灵抖得不是时候	感觉会被喷
      1 这本身就是对自己身份的拒绝接纳	这种行为给自己
      1 这更是尖锐啊	同性恋开始意识自己喜欢同性的时候
      1 这是排在最前面的一条	排序是按点赞量
      1 这是很流行的错误认知	猫结婚吗
      1 这才是婚姻的意义	它约束了性关系
      1 这就是歧视	还有
      1 这就是很糟糕的	要知道
      1 这就很糟糕了	人最基本的欲求
      1 这反对者当中	既有异性恋
      1 这些都是因为异性恋者对同性恋的歧视造成的	这话说得不对
      1 这么说的人	是逻辑和常识水平不行
      1 这个过程呈现出的方方面面似乎都能被贴上错误的标签	甚至被认为是自己对自己的歧视
      1 这个说法	有点意思了
      1 这个词	猫狗没有
      1 这个1	不是不变的
      1 这一点很可怕	来自豆瓣App
      1 这一点很可怕	小飞
      1 还迫害他人	一个人要自己认可自己
      1 还要负法律责任	人类社会
      1 还要让同性婚姻合法化	怎么得了
      1 还能有稳定的家庭关系	人的欲望里
      1 还有点爱情	结了婚
      1 还有	文章提到
      1 还强行说同性恋歧视	自己
      1 还喜欢秦钟	我们说一个人是直男
      1 过去很多人	既好女色
      1 边	难
      1 转发	赞
      1 转发	16
      1 轨还没建立起来呢	同样
      1 轨	也没有建立起来
      1 躲得起	回应
      1 身为同性恋又对同性恋问题完全不发声	不表态
      1 赞赏	木道人
      1 赞赏	2
      1 赞	转发
      1 赞	收藏
      1 贾宝玉不仅喜欢林黛玉	还喜欢秦钟
      1 贪污受贿的	杀人放火的
      1 貌似这篇文章是很中肯中立的分析	并没有用什么具有伤害性的言语针对同性恋群体
      1 豆芽	监狱里那么多强奸的
      1 豆芽	2017
      1 豆瓣社区	搜索
      1 豆瓣摄影	豆瓣社区
      1 豆瓣广告	IFRAME
      1 豆瓣	读书
      1 豆瓣	扫码直接下载
      1 豆瓣	6
      1 豆品	更多
      1 谈恋爱的时候	想分手就分手
      1 谈恋爱他很自由	结了婚就不自由了
      1 谈同性婚姻	首先要了解
      1 读书	电影
      1 说得好	回应
      1 说一个人是异性恋	并不代表他是百分之百的异性恋
      1 诱导他们发展对同性的性欲	因此
      1 误解的地方生活	去做争取权利的事情
      1 误解	不仅是因为异性恋者
      1 语气听起来也不情绪化	似乎蛮有道理的
      1 该积极意义大过消极作用	台湾去年的调查显示
      1 话题广场	new
      1 评论	这是排在最前面的一条
      1 记忆里与过年有关的童谣	8194人浏览
      1 让繁衍后代的活动变得有序	2
      1 让社会行为变得更有序的才豁然开朗	感谢
      1 让社会更加有序	之所以人类社会不是动物世界
      1 让王路和我睡一睡	看看能不能变成同性恋
      1 让我觉得	作为一个同性恋
      1 认为同性恋跟后天的影响有关	可不管先天后天
      1 觉得你和几年前相比已经立场柔和了很多	但是有很多东西并不
      1 规范了他	约束了他
      1 要集齐十二星座	三十四省
      1 要认识到这一点	首先得承认一个前提
      1 要缓解这种问题	恰恰不能靠禁止同性恋
      1 要知道	今天的同性恋群体
      1 要理解个体之	间存在着巨大的差异
      1 要抑制他的花心	如果一个人既有爱
      1 要在爱和花心之间做一个平衡	要呵护一个人的爱
      1 要呵护一个人的爱	同时
      1 要了小孩就更不自由了	将来离婚也麻烦
      1 袖	边
      1 表示他身上同性恋倾向比较低	比方只有1
      1 行规范的开始	有助于许多社会问题的减少
      1 虽然看起来似乎不太像	但实际上
      1 虽然有外界不接纳等因素的关系	但是还是同性恋本身进
      1 虽然实质上都是背叛	但前者性质比后者轻
      1 虽然只是极少数人	但这群人的确存在
      1 莫过于	鼓励异性恋者选择同性取向
      1 莫忘呼吸	把
      1 莫忘呼吸	2017
      1 范晓萱	在四十岁后听歌的女人很美
      1 范晓萱	2017
      1 花心	的一面
      1 艾滋病	吸毒
      1 舒啸	登东皋以舒啸
      1 舒啸	2017
      1 至少比	繁衍后代
      1 自由自在	没有约束
      1 自己是这样	不代表别人都是这样
      1 自己就被耽误了	但对另一些人来讲
      1 自己	人本应生而平等
      1 能看出来你是女性	对于女性遭受的不平等和摧毁性的待遇有更多的同理心和愤慨
      1 能不能从佛教的角度解读同性恋	回应
      1 聪明不绝顶	尖锐不湿疣
      1 联系我们	免责声明
      1 聊聊缘起性空	27人喜欢
      1 而那些在阴影下的人只能成为丑闻或者笑柄	无论公开还是背后私下
      1 而这种鼓励	有可能会刺激少数异性恋者
      1 而自己却选择逃避	雾里看花
      1 而自己却选择逃避	回应
      1 而民众的观念转变尚未到位	造成冲突
      1 而是因为不能接纳自己	一切不能接纳自己的人
      1 而是同性恋者自身对同性恋的歧视	这更是尖锐啊
      1 而是单纯希望瘾君子贩毒者和这个环境的弱势群体去解决这个问题一样	同性恋群体的问题不是几个
      1 而是	反对同性恋者
      1 而在于心存差别	同性恋倾向从1
      1 而同性情侣	哪怕建立了亲密关系
      1 而同性婚姻合法化	很多时候
      1 而且整个社会去正视这个问题	人们都觉得慢慢的这个问题就会有转机
      1 老人的赡养	都成问题
      1 美国同性婚姻合法化时	我写过一篇
      1 给爱情一个庇护所	这个说法
      1 结婚	或者出于没有法律约束
      1 结婚	呢
      1 结了婚就不自由了	要了小孩就更不自由了
      1 结了婚	爱情很快耗光了
      1 结了婚	你就不能到处乱搞
      1 结不结婚又有什么所谓	合不合法都跟我没关系
      1 约束的	同性婚姻合法化
      1 约束了他	很多心思
      1 繁衍后代并不需要婚姻	不结婚也可以生子
      1 繁衍后代	靠谱一点
      1 紧跟着的第二	第三条是
      1 素烟老竹	王老师天理人欲讲的蛮好的
      1 素烟老竹	2017
      1 精诚所至	完了
      1 粉转黑	暴露了作者的短板
      1 等等	种种
      1 等到同婚	合法化的时候
      1 第二条比较情绪化	可以不论
      1 第三条是	第二条比较情绪化
      1 第三条义正辞严	教人家
      1 第一条说的很好	没义务支持
      1 移动应用	豆瓣广告
      1 积极的	但也有不好的
      1 种种	则无异于自己迫害自己
      1 社会也会乱成一团糟	儿童的抚育
      1 真的正确吗	也许值得再唠唠
      1 看看能不能变成同性恋	回应
      1 看到您提到	婚姻是约束人类行为的
      1 看到一些网上的	评论
      1 相信命运握在手	才能亲手打脸
      1 直接体现出某种观点	认为同性恋跟后天的影响有关
      1 直到	看到您提到
      1 监狱里那么多强奸的	猥亵幼童的
      1 的说法	遛狗时
      1 的群体里	长期和同性相处
      1 的民众赞成同性婚姻	45
      1 的民众反对	未来
      1 的态度	把很多中立者
      1 的一面	爱一个人
      1 的一面	又有
      1 百分之百地排斥	同性之间的爱
      1 登录	注册
      1 登东皋以舒啸	临清流而赋诗
      1 留在同性恋	仍然遭受歧视
      1 画出你喜欢的咖啡店	775人浏览
      1 电影	音乐
      1 由于不敢公开	他们之间的关系破碎更容易
      1 生而被歧视	回应
      1 生而为人的权利	而那些在阴影下的人只能成为丑闻或者笑柄
      1 甚至装作异性恋去跟人谈恋爱	结婚
      1 甚至被认为是自己对自己的歧视	文章闭口不谈来自异性恋的歧视
      1 甚至流浪猫比人繁衍得快多了	繁衍后代并不需要婚姻
      1 理解同性恋的地区	同性婚姻的合法化
      1 王路的最新日记	全部
      1 王路	阎浮众生刚强难化
      1 王路	聊聊缘起性空
      1 王路	猪年念佛对联
      1 王路	所有
      1 王路	寒夜打车
      1 王路	同性恋婚姻合法化好吗
      1 王路	又写三副猪年对联
      1 王路	北京
      1 王路	2017
      1 王老师天理人欲讲的蛮好的	可惜其他人喷或赞都只靠屁股位子和己见
      1 王凰名	相信命运握在手
      1 王凰名	2017
      1 猫结婚吗	狗结婚吗
      1 猫狗没有	出轨
      1 猫狗并没有从地球上绝种	甚至流浪猫比人繁衍得快多了
      1 猪年念佛对联	13人喜欢
      1 猥亵幼童的	卖淫嫖娼的
      1 独立思考	不要被洗脑
      1 狗结婚吗	猫狗并没有从地球上绝种
      1 父母把他当女孩养	或者在青春期
      1 爱情很快耗光了	婚姻甚至会导致爱情的破产
      1 爱很多人	叫花心
      1 爱少的人	每每薄情
      1 爱多的人	每每花心
      1 爱和花心	常常是交织在一起的
      1 爱一个人	叫爱
      1 爱	的一面
      1 热门话题	去话题广场
      1 满足的	但过度的欲求
      1 滋长了	同性婚姻合法化
      1 深圳一姐小渡边	聪明不绝顶
      1 深圳一姐小渡边	2017
      1 浏览发现	话题广场
      1 流浪和幻想	这机灵抖得不是时候
      1 注册	下载豆瓣客户端
      1 没结婚	还有点爱情
      1 没有约束	这就是很糟糕的
      1 没有狗仔会抓拍	没有别的狗告它性骚扰
      1 没有别的狗告它性骚扰	因为婚姻约束了人类的性行为
      1 没义务支持	更没义务欣赏
      1 没	有这种约束
      1 沉默是金	最可怜神的是他们不能自杀
      1 沉默是金	2017
      1 沉住气	吃硬饭
      1 比较简单	也比较轻松
      1 比方说	一个男孩
      1 比方只有1	所以基本对同性
      1 比如	说一个人是异性恋
      1 毒品	动荡的社会环境造成的犯罪率提升是相同
      1 每每薄情	所以
      1 每每花心	爱少的人
      1 歧视同性	恋的
      1 歧视	这种误解
      1 歧视	并不能靠一部法律马上消除
      1 正是这样的东西	呵护爱
      1 正好纵溺自己保持多重性伙伴关系	等等
      1 正好想跟谁玩跟谁玩	自由自在
      1 正因为有婚姻	规范了他
      1 正因为婚姻约束了性关系	才让缔结了家庭的人
      1 枕	上
      1 来看待同性恋	这就是歧视
      1 杀人放火的	十有八九都是
      1 本来恋爱谈得好好的	一提到结婚
      1 本文版权归	王路
      1 未来	应该有更多地方允许同性婚姻合法化
      1 未必在于心存伤害	而在于心存差别
      1 木道人	我想背着一把断剑
      1 木道人	2017
      1 朋友	从不在别的场合表示自己的恋爱状态
      1 有这种约束	我们会说谈恋爱的情侣
      1 有积极意义	也会带来消极影响
      1 有点意思了	虽然看起来似乎不太像
      1 有可能会刺激少数异性恋者	出于新奇
      1 有助于许多社会问题的减少	是有积极意义的
      1 有助于同性亲密关系的稳定	3
      1 有人谈恋爱谈了七八年	再不结婚
      1 有人说	艾滋病
      1 有人说	给爱情一个庇护所
      1 有人说	是繁衍后代
      1 有人说	我有
      1 有人说	你看那些
      1 有人讲	我明白了
      1 有人有	有人是异性恋
      1 有人是异性恋	却
      1 有人不爱结婚	但是爱谈恋爱
      1 有些人把寻找	性伴侣的行为叫
      1 有两种选择	一种是
      1 有	出轨
      1 最大的消极影响	莫过于
      1 最可怜神的是他们不能自杀	不支持不反对也是一种态度
      1 更重要的是来自同性恋者自身对同性恋的歧视	他们隐藏自己的取向和异性结婚
      1 更没义务欣赏	惹不起
      1 更多	豆瓣摄影
      1 暴露了作者的短板	来自豆瓣App
      1 是需要抑制	约束的
      1 是逻辑和常识水平不行	如果取消异性婚姻
      1 是这种同性恋者	结不结婚又有什么所谓
      1 是身为同性恋却反对同	性恋的
      1 是繁衍后代	这是很流行的错误认知
      1 是有积极意义的	但同时
      1 是很多社会问题产生的原因	要缓解这种问题
      1 是应当给予照顾	满足的
      1 是对同性恋的极大鼓励	而这种鼓励
      1 是你的自由	来自豆瓣App
      1 是人类有婚姻	结了婚
      1 是一种照顾	保障了他们的权益
      1 易破坏它	而同性情侣
      1 易变	是很多社会问题产生的原因
      1 明海	精诚所至
      1 明海	2017
      1 时间	豆品
      1 既有异性恋	也有很大一部分
      1 既有	爱
      1 既好女色	又好娈童
      1 既不支持	也不反对
      1 无论哪一种	都是好的
      1 无论公开还是背后私下	或许你觉得只有那些同妻女性的痛苦才是值得你同情
      1 新话题	12666人浏览
      1 新浪微博	QQ好友
      1 新书	沉住气
      1 文章闭口不谈来自异性恋的歧视	还强行说同性恋歧视
      1 文章提到	并不是异性恋者在歧视
      1 文学作品中令你印象深刻的一家人	28965人浏览
      1 教人家	独立思考
      1 收藏	赞赏
      1 搜索你感兴趣的内容和人	______________________
      1 搜索	首页
      1 搜索	搜索你感兴趣的内容和人
      1 提	到买车买房
      1 推到了对立面	回应
      1 接纳同性恋	允许同性婚姻的地方生活
      1 接下来可能想要集齐两性了	这就很糟糕了
      1 排序是按点赞量	紧跟着的第二
      1 换句话说	它是可以培养的
      1 拭	总结就是一句话
      1 拒绝带女朋友见自己的	朋友
      1 拂	拭
      1 抑制花心	但是
      1 把很多中立者	或者温和的反对者
      1 扫码直接下载	iPhone
      1 才让缔结了家庭的人	性伙伴稳定下来
      1 才能说既不支持也不反对的话吧	是你的自由
      1 才能亲手打脸	对婚姻的理解有些肤浅
      1 才有可能	得到别人的认可
      1 所有	任何形式转载请联系作者
      1 所以基本对同性	不会有爱欲的兴趣
      1 所以后面的内容也就更隔靴搔痒了	来自豆瓣App
      1 所以会出现各种各样的问题	4
      1 所以	要在爱和花心之间做一个平衡
      1 或许你觉得只有那些同妻女性的痛苦才是值得你同情	同性恋群体并不值
      1 或者温和的反对者	推到了对立面
      1 或者在青春期	到了一个只有男性没有女性
      1 或者出于没有法律约束	正好纵溺自己保持多重性伙伴关系
      1 我认同的过程	这个过程呈现出的方方面面似乎都能被贴上错误的标签
      1 我觉得写得挺好的	来自豆瓣App
      1 我的理解是	让社会更加有序
      1 我来回应	王路
      1 我本来没有什么想写的	不过
      1 我有	但我从没想和他发生性关系
      1 我是同性恋	来自豆瓣App
      1 我明白了	你的意思就是
      1 我想背着一把断剑	流浪和幻想
      1 我口吃	让一个内心就是带有歧视
      1 我出什么轨	轨还没建立起来呢
      1 我写过一篇	儒家对今日同性婚姻之态度
      1 我们说的同性恋和异性恋	都不是百分之百的
      1 我们说一个人是直男	表示他身上同性恋倾向比较低
      1 我们会说谈恋爱的情侣	劈腿
      1 我两年前的文章	儒家对今日同性婚姻之态度
      1 慕南	第一条说的很好
      1 慕南	2017
      1 感谢	回应
      1 感觉都挺合理的	直到
      1 感觉会被喷	回应
      1 惹不起	躲得起
      1 想换对象就换对象	很多人
      1 想分手就分手	想换对象就换对象
      1 想偷吃	也得偷偷摸摸的
      1 恰恰不能靠禁止同性恋	同性恋没法禁止
      1 恋的	有人说
      1 总结就是一句话	既不支持
      1 总有一个不变抗这所有的变	写的蛮好
      1 性恋的	为了避免伤害
      1 性伴侣的行为叫	集邮
      1 性伙伴稳定下来	即便他想出轨
      1 怕男方把她甩了	自己就被耽误了
      1 怎么得了	这么说的人
      1 快速注册	王路
      1 心里不踏实	怕男方把她甩了
      1 微信扫码	新浪微博
      1 得到别人的认可	否则
      1 得你分毫的同情和关注	那只能期待某天你能理解了
      1 很重要的原因	是人类有婚姻
      1 很容易理解	你难道对睡你上铺的弟兄一点感情都没有吗
      1 很多时候	有助于同性亲密关系的稳定
      1 很多心思	他只敢脑子里边动动
      1 很多地区	对同性恋还存在很大误解
      1 很多同性情侣	关系不敢公开
      1 很多人	尤其是哪些不能专心专意地在一个人身上用情的人
      1 很多人	你不支持我就是反对我
      1 很可能是被动的	比方说
      1 彩礼	可能两家就闹掰了
      1 当谈论到什么原因形成了同性恋	就是心存差别的
      1 异性恋群体	没
      1 异性恋	为什么不禁止异性恋
      1 应该有更多地方允许同性婚姻合法化	对同性恋的误解和歧视
      1 应	该积极意义大过消极作用
      1 并没有用什么具有伤害性的言语针对同性恋群体	可歧视的本质
      1 并不能靠一部法律马上消除	反而会因为法律出台过早
      1 并不代表他是百分之百的异性恋	也就是说
      1 年货怎么买	113042人浏览
      1 干戚	同意
      1 干戚	Here
      1 干戚	2017
      1 常常是交织在一起的	爱多的人
      1 帮助中心	移动应用
      1 尽说错话	让一个内心就是带有歧视
      1 就目前的情况看	在全世界都允许同性婚姻合法
      1 就是模范了	婚姻
      1 就是心存差别的	来看待同性恋
      1 就和贫穷	毒品
      1 就像不能禁止人有爱欲	而同性婚姻合法化
      1 就不仅是道德问题	还要负法律责任
      1 就一天没有保障	心里不踏实
      1 尤其是哪些不能专心专意地在一个人身上用情的人	通常是不喜欢婚姻的
      1 尖锐不湿疣	严肃文学
      1 少	不过
      1 小飞	把同妻的问题抛给同性恋有什么不公平可言
      1 小组	阅读
      1 将来离婚也麻烦	谈恋爱的时候
      1 对性向有什么误解吗	来自豆瓣App
      1 对异性永远不可能产生像对同性那么重的爱欲的人来说	是一种照顾
      1 对婚姻的理解有些肤浅	只从社会角度考虑
      1 对同性恋还存在很大误解	歧视
      1 对同性恋的误解和歧视	会越来越
      1 对于那些比较能够接受	理解同性恋的地区
      1 对于那些天生就是同性恋	对异性永远不可能产生像对同性那么重的爱欲的人来说
      1 对于少数特殊的人来说	可能会起到不良的鼓励作用
      1 对于女性遭受的不平等和摧毁性的待遇有更多的同理心和愤慨	这都可以理解
      1 对于他们	有两种选择
      1 寒夜打车	55人喜欢
      1 家庭建立不起来	社会也会乱成一团糟
      1 家庭关系才得以建立	如果没有婚姻
      1 家庭	多痛苦啊
      1 完了	粉转黑
      1 完	我两年前的文章
      1 它约束了性关系	同时也保护了性关系
      1 它是可以培养的	在有些人身上
      1 婚都没结呢	我出什么轨
      1 婚姻的意义到底是什么呢	我的理解是
      1 婚姻甚至会导致爱情的破产	本来恋爱谈得好好的
      1 婚姻是约束人类行为的	让社会行为变得更有序的才豁然开朗
      1 婚姻是爱情的坟墓	没结婚
      1 婚姻	伦理
      1 婚前乱搞	人家只能批评批评你的道德
      1 姑娘就着急了	为什么呢
      1 如果没有婚姻	人类随意交配
      1 如果没有合法的婚姻	他们的
      1 如果有人总是在别人面前回避他的恋爱关系	拒绝带女朋友见自己的
      1 如果取消异性婚姻	会发现这些问题马上就在异性恋群体中出现
      1 如果一个人离婚很多次	别人也会觉得这人有问题
      1 如果一个人既有爱	又不花心
      1 如果一个人三天两头换女朋友	别人会觉得这人人品有问题
      1 好好努力	去那些能够尊重
      1 太阳尚远	但必有太阳
      1 天亮说晚安	太阳尚远
      1 天亮说晚安	2017
      1 大鱼	我是同性恋
      1 大鱼	2017
      1 多痛苦啊	这些都是因为异性恋者对同性恋的歧视造成的
      1 培养到30	要理解个体之
      1 培养到30	直接体现出某种观点
      1 在龙空看到有评论说	1你又不是同性恋
      1 在豆瓣工作	联系我们
      1 在歧视	迫害同性恋
      1 在极度需要支持和鼓励的环境下	倡导大家不鼓励
      1 在有些人身上	可能怎么培养都不会变
      1 在异性情侣中	如果有人总是在别人面前回避他的恋爱关系
      1 在四十岁后听歌的女人很美	你接纳自己同性恋的身份
      1 在同性恋群体中	同性婚姻没有合法化
      1 在全世界都允许同性婚姻合法	也许过早
      1 因此	还能有稳定的家庭关系
      1 因此	就目前的情况看
      1 因地	因人而异
      1 因人而异	同性婚姻的合法化
      1 因为婚姻约束了人类的性行为	家庭关系才得以建立
      1 因为	一天不结婚
      1 回应	转发
      1 噗兄	枕
      1 噗兄	2017
      1 嘻嘻哈哈哦	再不相愛就老了
      1 嘻嘻哈哈哦	2017
      1 哪怕有亲密关系	如果没有合法的婚姻
      1 哪怕建立了亲密关系	由于不敢公开
      1 和同性恋相关的社会问题很多	有人说
      1 和别人带来的痛苦	不是因为自己是同性恋
      1 呵护爱	抑制花心
      1 呵呵	在极度需要支持和鼓励的环境下
      1 呢	回应
      1 吸毒贩毒的	贪污受贿的
      1 吸毒	乱交这些现象在同性恋群体中非常普遍
      1 吧	干戚
      1 吧	回应
      1 否则就会受到舆论的惩罚	但是
      1 否则	别人为他的幸福努力
      1 同样	同性恋者
      1 同时也保护了性关系	让繁衍后代的活动变得有序
      1 同时	要抑制他的花心
      1 同时	也是对同性伦理进
      1 同意	来自豆瓣App
      1 同性恋者	哪怕有亲密关系
      1 同性恋群体的问题不是几个	人去正视自己的就能解决问题
      1 同性恋群体并不值	得你分毫的同情和关注
      1 同性恋的倾向	可能慢慢就被培养
      1 同性恋没法禁止	就像不能禁止人有爱欲
      1 同性恋是被压抑的	难道不应该支持
      1 同性恋开始意识自己喜欢同性的时候	需要一个自
      1 同性恋婚姻合法化好吗	王路
      1 同性恋倾向从1	培养到30
      1 同性婚姻的合法化	有积极意义
      1 同性婚姻的合法化	应
      1 同性婚姻没有合法化	同性伦理没有建立起来
      1 同性婚姻就应当合法化	全世界都该让同性婚姻合法
      1 同性婚姻合法化和你有什么关系呢	2反正同性也不需要小孩
      1 同性婚姻合法化	是对同性恋的极大鼓励
      1 同性婚姻合法化	对于那些天生就是同性恋
      1 同性婚姻为什么需要合法化呢	感觉都挺合理的
      1 同性伦理没有建立起来	所以会出现各种各样的问题
      1 同性亲密关系的不稳定	易变
      1 同性之间的爱	很容易理解
      1 同妻	家庭
      1 同城	小组
      1 合法化的时候	才能说既不支持也不反对的话吧
      1 合不合法都跟我没关系	正好想跟谁玩跟谁玩
      1 吃硬饭	https
      1 台湾推动同性婚姻合法化	我本来没有什么想写的
      1 台湾去年的调查显示	46
      1 可能慢慢就被培养	滋长了
      1 可能怎么培养都不会变	但在另一些人身上
      1 可能会起到不良的鼓励作用	诱导他们发展对同性的性欲
      1 可能从1	培养到30
      1 可能两家就闹掰了	那
      1 可歧视的本质	未必在于心存伤害
      1 可惜其他人喷或赞都只靠屁股位子和己见	来自豆瓣App
      1 可传递出的理念	让我觉得
      1 可以不论	第三条义正辞严
      1 可不管先天后天	当谈论到什么原因形成了同性恋
      1 叫花心	爱和花心
      1 叫爱	爱很多人
      1 只存在于汉语里的精妙词语	133965人浏览
      1 只从社会角度考虑	所以后面的内容也就更隔靴搔痒了
      1 另一种是	留在同性恋
      1 反而会因为法律出台过早	而民众的观念转变尚未到位
      1 反对同性恋者	在歧视
      1 又有	花心
      1 又好娈童	贾宝玉不仅喜欢林黛玉
      1 又写三副猪年对联	5人喜欢
      1 又不花心	就是模范了
      1 去那些能够尊重	接纳同性恋
      1 去话题广场	冬日赏花记
      1 去尝试同性的恋爱关系	虽然只是极少数人
      1 去做争取权利的事情	一点点改变生态
      1 却被他辜负了	完
      1 却	不排斥同性的性关系
      1 即便他想出轨	想偷吃
      1 卖淫嫖娼的	吸毒贩毒的
      1 十有八九都是	异性恋
      1 十四	在龙空看到有评论说
      1 十四	2017
      1 十之八九	他没打算和她进入婚姻
      1 北京豆网科技有限公司	关于豆瓣
      1 北京	公众号
      1 努力和享受当下	其实人都愿意看到自己想看到的东西
      1 动荡的社会环境造成的犯罪率提升是相同	人在极端环境下进行的极端选择
      1 劈腿	但不大说他们
      1 到了一个只有男性没有女性	的群体里
      1 到买车买房	彩礼
      1 别人接纳你吗	回应
      1 别人会觉得这人人品有问题	如果一个人离婚很多次
      1 别人也会觉得这人有问题	一旦亲密关系公开
      1 别人为他的幸福努力	却被他辜负了
      1 删除	静静
      1 删除	雾里看花
      1 删除	都叫我小瑞瑞
      1 删除	豆芽
      1 删除	莫忘呼吸
      1 删除	范晓萱
      1 删除	舒啸
      1 删除	素烟老竹
      1 删除	王凰名
      1 删除	深圳一姐小渡边
      1 删除	沉默是金
      1 删除	明海
      1 删除	我来回应
      1 删除	慕南
      1 删除	干戚
      1 删除	天亮说晚安
      1 删除	大鱼
      1 删除	噗兄
      1 删除	嘻嘻哈哈哦
      1 删除	十四
      1 删除	修还行
      1 删除	仓鼠飞轮
      1 删除	云汀
      1 删除	sususlsz
      1 删除	Aza
      1 则无异于自己迫害自己	非但迫害自己
      1 出轨	这个词
      1 出轨	虽然实质上都是背叛
      1 出轨	的说法
      1 出于新奇	去尝试同性的恋爱关系
      1 冬日赏花记	新话题
      1 写的蛮好的	来自豆瓣App
      1 写的蛮好	中立中肯
      1 再不结婚	姑娘就着急了
      1 再不相愛就老了	让王路和我睡一睡
      1 内心的自大淋漓尽致	都叫我小瑞瑞
      1 内心的自大淋漓尽致	说得好
      1 内心的自大淋漓尽致	让一个内心就是带有歧视
      1 内心的自大淋漓尽致	回应
      1 其实	并不是异性恋者在歧视
      1 其实	公开是对稳定关系的保护和约束
      1 关系不敢公开	其实
      1 关于豆瓣	在豆瓣工作
      1 公开是对稳定关系的保护和约束	在异性情侣中
      1 公众号	i_wanglu
      1 全部	王路
      1 全新发布	豆瓣
      1 全世界都该让同性婚姻合法	不
      1 免责声明	帮助中心
      1 允许同性婚姻的地方生活	这条路
      1 儿童的抚育	老人的赡养
      1 儒家对今日同性婚姻之态度	这次
      1 儒家对今日同性婚姻之态度	本文版权归
      1 倡导大家不鼓励	问题是现在
      1 修还行	总有一个不变抗这所有的变
      1 修还行	2017
      1 保障了他们的权益	同时
      1 你难道对睡你上铺的弟兄一点感情都没有吗	有人说
      1 你看那些	同妻
      1 你的意思就是	同性婚姻就应当合法化
      1 你没有	有人有
      1 你接纳自己同性恋的身份	别人接纳你吗
      1 你就不能到处乱搞	婚前乱搞
      1 你不支持我就是反对我	的态度
      1 作为一个同性恋	生而被歧视
      1 但这群人的确存在	不能忽略他们的存在
      1 但这种见地	真的正确吗
      1 但过度的欲求	是需要抑制
      1 但是这个问题背后的原因	就和贫穷
      1 但是还是同性恋本身进	把同妻的问题抛给同性恋有什么不公平可言
      1 但是缓慢只会让几代的这个群体里的精英才能通过移民有	生而为人的权利
      1 但是爱谈恋爱	谈恋爱他很自由
      1 但是有很多东西并不	其实人都愿意看到自己想看到的东西
      1 但是支持同性恋婚姻合法化	回应
      1 但是就像你希望根	除毒品带来的犯罪问题
      1 但是	这个1
      1 但是	身为同性恋又对同性恋问题完全不发声
      1 但是	异性恋群体
      1 但是	在同性恋群体中
      1 但我从没想和他发生性关系	你没有
      1 但必有太阳	貌似这篇文章是很中肯中立的分析
      1 但对另一些人来讲	婚姻是爱情的坟墓
      1 但实际上	至少比
      1 但婚后乱搞	就不仅是道德问题
      1 但在另一些人身上	可能从1
      1 但同时	对于少数特殊的人来说
      1 但前者性质比后者轻	婚都没结呢
      1 但他们的行为是反对同性恋	歧视同性
      1 但也有不好的	是这种同性恋者
      1 但不大说他们	出轨
      1 似乎还是	把
      1 似乎蛮有道理的	但这种见地
      1 伦理	正是这样的东西
      1 会越来越	少
      1 会比较艰难	也比较累
      1 会有舆论的压力迫使你不轻	易破坏它
      1 会发现这些问题马上就在异性恋群体中出现	正因为婚姻约束了性关系
      1 任何形式转载请联系作者	了解版权计划
      1 以及同性之间的性行为	百分之百地排斥
      1 他没打算和她进入婚姻	如果一个人三天两头换女朋友
      1 他对同性之间的爱	以及同性之间的性行为
      1 他只敢脑子里边动动	不方便做
      1 他们隐藏自己的取向和异性结婚	这本身就是对自己身份的拒绝接纳
      1 他们的	轨
      1 他们是同性恋	但他们的行为是反对同性恋
      1 他们之间的关系破碎更容易	同性亲密关系的不稳定
      1 仓鼠飞轮	鼓励异性恋者选择同性恋
      1 仓鼠飞轮	2017
      1 从小穿女孩的衣服	父母把他当女孩养
      1 从不在别的场合表示自己的恋爱状态	十之八九
      1 仍然遭受歧视	误解的地方生活
      1 今天的很多同性恋者	也许活不到那个时候
      1 今天的同性恋群体	之所以还遭受歧视
      1 人类随意交配	随意繁殖
      1 人类社会	有
      1 人的欲望里	既有
      1 人本应生而平等	可传递出的理念
      1 人最基本的欲求	是应当给予照顾
      1 人家只能批评批评你的道德	但婚后乱搞
      1 人在极端环境下进行的极端选择	个案造成的伤害当然应当谴责个体的道德水准
      1 人去正视自己的就能解决问题	而且整个社会去正视这个问题
      1 人们都觉得慢慢的这个问题就会有转机	但是缓慢只会让几代的这个群体里的精英才能通过移民有
      1 产生更大的失序	不过
      1 产生同妻问题的同志是不可原谅的	但是这个问题背后的原因
      1 云汀	能不能从佛教的角度解读同性恋
      1 云汀	2017
      1 事实上	很可能是被动的
      1 了解版权计划	赞赏
      1 乱交这些现象在同性恋群体中非常普遍	还要让同性婚姻合法化
      1 也许过早	很多地区
      1 也许活不到那个时候	对于他们
      1 也许值得再唠唠	1
      1 也没有建立起来	很多同性情侣
      1 也比较轻松	另一种是
      1 也比较累	不过
      1 也有很大一部分	是身为同性恋却反对同
      1 也是对同性伦理进	行规范的开始
      1 也得偷偷摸摸的	否则就会受到舆论的惩罚
      1 也就是说	他对同性之间的爱
      1 也因为这一部分同性恋者	他们是同性恋
      1 也会带来消极影响	最大的消极影响
      1 也不是	这要因时
      1 也不反对	呵呵
      1 之所以还遭受歧视	误解
      1 之所以人类社会不是动物世界	很重要的原因
      1 为自己的幸福努力	才有可能
      1 为什么呢	因为
      1 为什么不禁止异性恋	结婚
      1 为了避免伤害	隐藏性取向是可以理解的
      1 临清流而赋诗	写的蛮好的
      1 中立中肯	来自豆瓣App
      1 个案造成的伤害当然应当谴责个体的道德水准	但是就像你希望根
      1 严肃文学	回应
      1 两年前	美国同性婚姻合法化时
      1 不过	这需要时间
      1 不过	看到一些网上的
      1 不过	无论哪一种
      1 不过	对于那些比较能够接受
      1 不要被洗脑	语气听起来也不情绪化
      1 不表态	甚至装作异性恋去跟人谈恋爱
      1 不良的鼓励作用	似乎还是
      1 不能忽略他们的存在	有些人把寻找
      1 不结婚也可以生子	那
      1 不是因为自己是同性恋	而是因为不能接纳自己
      1 不是同性恋	但是支持同性恋婚姻合法化
      1 不是动员整个社会力量去铲除毒品	而是单纯希望瘾君子贩毒者和这个环境的弱势群体去解决这个问题一样
      1 不是不变的	换句话说
      1 不方便做	因此
      1 不支持不反对也是一种态度	很多人
      1 不排斥同性的性关系	过去很多人
      1 不单是同性恋	其实
      1 不会有爱欲的兴趣	但是
      1 不代表别人都是这样	这种培养
      1 不仅是因为异性恋者	也因为这一部分同性恋者
      1 不一定是主动的	事实上
      1 不	也不是
      1 下载豆瓣客户端	豆瓣
      1 上	袖
      1 三十四省	接下来可能想要集齐两性了
      1 一种是	好好努力
      1 一点点改变生态	这条路
      1 一旦亲密关系公开	会有舆论的压力迫使你不轻
      1 一提到结婚	提
      1 一天不结婚	就一天没有保障
      1 一只公狗朝一只不认识的母狗扑上去	没有狗仔会抓拍
      1 一切不能接纳自己的人	都会给自己和周围人带来痛苦
      1 一个男孩	从小穿女孩的衣服
      1 一个人要自己认可自己	为自己的幸福努力
      1 www	googletagmanager
      1 will	be
      1 Us	把
      1 sususlsz	everything
      1 sususlsz	2017
      1 rights	reserved
      1 reserved	北京豆网科技有限公司
      1 QQ空间	回应
      1 QQ好友	QQ空间
      1 ns	html
      1 new	快速注册
      1 iPhone	Android
      1 IFRAME	www
      1 id	GTM
      1 i_wanglu	新书
      1 https	book
      1 html	id
      1 Here	After
      1 GTM	5WP579
      1 googletagmanager	com
      1 FM	时间
      1 fine	我觉得写得挺好的
      1 Felicis	把同妻的问题抛给同性恋有什么不公平可言
      1 Felicis	其实人都愿意看到自己想看到的东西
      1 everything	will
      1 com	王路的最新日记
      1 com	ns
      1 com	all
      1 book	douban
      1 be	fine
      1 Aza	尽说错话
      1 Aza	2017
      1 Android	豆瓣
      1 all	rights
      1 After	Us
      1 9人喜欢	热门话题
      1 8194人浏览	文学作品中令你印象深刻的一家人
      1 775人浏览	2005
      1 6	0
      1 5人喜欢	王路
      1 5WP579	
      1 59	两年前
      1 56	36
      1 55人喜欢	王路
      1 55	沉默是金
      1 53	06
      1 52	王凰名
      1 52	10
      1 51	37
      1 49	修还行
      1 48	07
      1 47	豆芽
      1 47	范晓萱
      1 47	木道人
      1 47	十四
      1 46	3
      1 45	舒啸
      1 45	4
      1 45	16
      1 44	云汀
      1 44	15
      1 43	干戚
      1 42	慕南
      1 4	的民众反对
      1 4	有人讲
      1 38	仓鼠飞轮
      1 37	大鱼
      1 37	12
      1 36	小飞
      1 34	莫忘呼吸
      1 32	22
      1 31	雾里看花
      1 30	34
      1 3	的民众赞成同性婚姻
      1 3	有人不爱结婚
      1 2反正同性也不需要小孩	同性婚姻为什么需要合法化呢
      1 28965人浏览	画出你喜欢的咖啡店
      1 28	14
      1 28	12
      1 27人喜欢	王路
      1 27	Aza
      1 27	06
      1 27	01
      1 26	16
      1 26	11
      1 26	09
      1 25	45
      1 25	21
      1 24	44
      1 22	sususlsz
      1 22	27
      1 21	04
      1 21	03
      1 2019	douban
      1 2018	01
      1 2005	2019
      1 20	49
      1 20	30
      1 20	11
      1 2	赞
      1 2	和同性恋相关的社会问题很多
      1 1你又不是同性恋	同性婚姻合法化和你有什么关系呢
      1 19	51
      1 19	20
      1 19	14
      1 18	38
      1 18	37
      1 18	21
      1 18	11
      1 18	09
      1 17	59
      1 17	32
      1 17	22
      1 17	17
      1 16	微信扫码
      1 16	嘻嘻哈哈哦
      1 16	56
      1 16	45
      1 15	天亮说晚安
      1 15	03
      1 14	48
      1 14	43
      1 14	05
      1 13人喜欢	王路
      1 133965人浏览	记忆里与过年有关的童谣
      1 12666人浏览	年货怎么买
      1 12	噗兄
      1 12	53
      1 12	52
      1 12	24
      1 12	22
      1 12	18
      1 113042人浏览	只存在于汉语里的精妙词语
      1 11	42
      1 11	22
      1 11	11
      1 10	深圳一姐小渡边
      1 10	14
      1 1	谈同性婚姻
      1 09	静静
      1 09	31
      1 09	09
      1 07	素烟老竹
      1 07	52
      1 06	明海
      1 06	25
      1 05	都叫我小瑞瑞
      1 05	11
      1 05	10
      1 05	01
      1 04	小飞
      1 04	16
      1 03	55
      1 03	18
      1 01	44
      1 01	15
      1 01	07
      1 0	全新发布
      1 ______________________	搜索
